Loc PackedFile
Key	Text	Tooltip
character_trait_levels_colour_text_wh2_dlc09_skill_innate_skv_tretch_craventail	An audacious surprise attack on his predecessor has led to a new title for Tretch and an army to do his bidding.	true
character_trait_levels_onscreen_name_wh2_dlc09_skill_innate_skv_tretch_craventail	Grand Chieftain	true
character_trait_levels_colour_text_wh2_dlc09_skill_innate_tmb_arkhan	The monarch of the Undead, the liege of the Unliving.	true
character_trait_levels_onscreen_name_wh2_dlc09_skill_innate_tmb_arkhan	The Liche King	true
character_trait_levels_colour_text_wh2_dlc09_skill_innate_tmb_cavalry_master	The ties that hold man and beast together cannot be broken by death alone.	true
character_trait_levels_onscreen_name_wh2_dlc09_skill_innate_tmb_cavalry_master	Cavalry Master	true
character_trait_levels_colour_text_wh2_dlc09_skill_innate_tmb_channeller	This Liche Priest is so powerful he can tap energy directly from the Realm of Souls and direct it at will.	true
character_trait_levels_onscreen_name_wh2_dlc09_skill_innate_tmb_channeller	Channeller	true
character_trait_levels_colour_text_wh2_dlc09_skill_innate_tmb_chariot_master	Effective chariot warfare requires precise control - choreography, almost, if you will - if the victories sought by Unliving generals are to be achieved.	true
character_trait_levels_onscreen_name_wh2_dlc09_skill_innate_tmb_chariot_master	Chariot Master	true
character_trait_levels_colour_text_wh2_dlc09_skill_innate_tmb_dynasty_alkhazzar_ii	This warrior-king was unmatched in chariot tactics. Only the finest crews served under him - and will again, of course…	true
character_trait_levels_onscreen_name_wh2_dlc09_skill_innate_tmb_dynasty_alkhazzar_ii	Alkhazzar II of the Sixth Dynasty	true
character_trait_levels_colour_text_wh2_dlc09_skill_innate_tmb_dynasty_lahmizzash	Lahmizzash continued the fight against Nagash, retaking sacred Khemri with the aid of his potent Ushabti.	true
character_trait_levels_onscreen_name_wh2_dlc09_skill_innate_tmb_dynasty_lahmizzash	Lahmizzash of the Fourth Dynasty	true
character_trait_levels_colour_text_wh2_dlc09_skill_innate_tmb_dynasty_rakhash	Conquering lands beyond the mountains east of Nehekhara, Rakhash was a bringer of great prosperity.	true
character_trait_levels_onscreen_name_wh2_dlc09_skill_innate_tmb_dynasty_rakhash	Rakhash of the Second Dynasty	true
character_trait_levels_colour_text_wh2_dlc09_skill_innate_tmb_dynasty_setep	Ruling in the wake of the war with Nagash, Setep restored the Necropolis and the Priesthood to their former glory.	true
character_trait_levels_onscreen_name_wh2_dlc09_skill_innate_tmb_dynasty_setep	Setep of the Fifth Dynasty	true
character_trait_levels_colour_text_wh2_dlc09_skill_innate_tmb_dynasty_thutep	The son of Khetep ruled only briefly before his death, but his grasp of engineering and urban development were legendary.	true
character_trait_levels_onscreen_name_wh2_dlc09_skill_innate_tmb_dynasty_thutep	Thutep of the Third Dynasty	true
character_trait_levels_colour_text_wh2_dlc09_skill_innate_tmb_dynasty_wakhaf	Wakhaf repelled the nomads and secured the borders. He is a peerless master of desert warfare.	true
character_trait_levels_onscreen_name_wh2_dlc09_skill_innate_tmb_dynasty_wakhaf	Wakhaf of the First Dynasty	true
character_trait_levels_colour_text_wh2_dlc09_skill_innate_tmb_eternal	Time itself cannot harm those who have defied death.	true
character_trait_levels_onscreen_name_wh2_dlc09_skill_innate_tmb_eternal	Eternal	true
character_trait_levels_colour_text_wh2_dlc09_skill_innate_tmb_imbuer	This Necrotect knows all the secret hieroglyphic inscriptions required to strengthen his statuary constructs.	true
character_trait_levels_onscreen_name_wh2_dlc09_skill_innate_tmb_imbuer	Imbuer	true
character_trait_levels_colour_text_wh2_dlc09_skill_innate_tmb_infantry_master	The myriad Undead legions respond to their master's will without question.	true
character_trait_levels_onscreen_name_wh2_dlc09_skill_innate_tmb_infantry_master	Infantry Master	true
character_trait_levels_colour_text_wh2_dlc09_skill_innate_tmb_khalida	As the embodiment of the Asp Goddess in full fury, a wave of pure terror rolls over those who look upon her.	true
character_trait_levels_onscreen_name_wh2_dlc09_skill_innate_tmb_khalida	Beloved of Asaph	true
character_trait_levels_colour_text_wh2_dlc09_skill_innate_tmb_khatep	The oldest and wisest of the Liche Priests is the head of the Mortuary Cult's hieratic council.	true
character_trait_levels_onscreen_name_wh2_dlc09_skill_innate_tmb_khatep	Grand Hierophant	true
character_trait_levels_colour_text_wh2_dlc09_skill_innate_tmb_master_of_ceremony	"Revered One, Venerable One, Lord of Secrets, High Priest of the Temple of Years…"	true
character_trait_levels_onscreen_name_wh2_dlc09_skill_innate_tmb_master_of_ceremony	Master of Ceremony	true
character_trait_levels_colour_text_wh2_dlc09_skill_innate_tmb_prepared	Unlife is forever; it is therefore prudent to go willingly and prepared.	true
character_trait_levels_onscreen_name_wh2_dlc09_skill_innate_tmb_prepared	Prepared	true
character_trait_levels_colour_text_wh2_dlc09_skill_innate_tmb_proficient_caster	There are many perfectly-uttered litanies and precise incantations required to draw forth spirits from the Realm of Souls. This one knows them all. 	true
character_trait_levels_onscreen_name_wh2_dlc09_skill_innate_tmb_proficient_caster	Proficient Caster	true
character_trait_levels_colour_text_wh2_dlc09_skill_innate_tmb_scavenger	The Vulture-God assists the desert poozler, lest they lose their way 'neath the scorching desert sun.	true
character_trait_levels_onscreen_name_wh2_dlc09_skill_innate_tmb_scavenger	Scavenger	true
character_trait_levels_colour_text_wh2_dlc09_skill_innate_tmb_scorpion_carver	Imbued with the souls of ancient Liche Priests, Sokth's servants are unhindered by their mechanical bodies of metal and stone.	true
character_trait_levels_onscreen_name_wh2_dlc09_skill_innate_tmb_scorpion_carver	Scorpion Carver	true
character_trait_levels_colour_text_wh2_dlc09_skill_innate_tmb_serpent_carver	That which is sculpted in Qu'aph's noble image strikes with the strength of the Serpent-God.	true
character_trait_levels_onscreen_name_wh2_dlc09_skill_innate_tmb_serpent_carver	Serpent Carver	true
character_trait_levels_colour_text_wh2_dlc09_skill_innate_tmb_settra	Settra is a brutal warlord and powerful sorcerer combined to deadly effect; ageless, deathless, venomous, and almost entirely without peer.	true
character_trait_levels_onscreen_name_wh2_dlc09_skill_innate_tmb_settra	Great King of Nehekhara	true
character_trait_levels_colour_text_wh2_dlc09_skill_innate_tmb_sphinx_carver	The stuff of myth and nightmares made stone, and later terrifying, savage reality.	true
character_trait_levels_onscreen_name_wh2_dlc09_skill_innate_tmb_sphinx_carver	Sphinx Carver	true
character_trait_levels_colour_text_wh2_dlc09_skill_innate_tmb_treacherous	The God of the Scorpions protects the venal, the perfidious, and the downright murderous.	true
character_trait_levels_onscreen_name_wh2_dlc09_skill_innate_tmb_treacherous	Treacherous	true
character_trait_levels_colour_text_wh2_dlc09_skill_innate_tmb_trustworthy	The people of the desert live and die by their oaths in Basth's graceful sight.	true
character_trait_levels_onscreen_name_wh2_dlc09_skill_innate_tmb_trustworthy	Trustworthy	true
character_trait_levels_colour_text_wh2_dlc09_skill_innate_tmb_ushabti_carver	Djaf's servants bring brutal, jackal-headed death to his unfortunate foes.	true
character_trait_levels_onscreen_name_wh2_dlc09_skill_innate_tmb_ushabti_carver	Ushabti Carver	true
character_trait_levels_colour_text_wh2_dlc09_skill_innate_tmb_wise	Benevolent Tahoth imparts sacred knowledge and timeless wisdom to his people.	true
character_trait_levels_onscreen_name_wh2_dlc09_skill_innate_tmb_wise	Wise	true
character_trait_levels_colour_text_wh2_dlc09_skill_innate_tmb_wrathful	The Tomb Kings and their servants feel Khsar's wrath coursing through their Unliving veins.	true
character_trait_levels_onscreen_name_wh2_dlc09_skill_innate_tmb_wrathful	Wrathful	true
character_trait_levels_colour_text_wh2_dlc10_skill_innate_def_hellebron	There is no-one more devoted to murder than Crone Hellebron, greatest of all Khaine’s brides.	true
character_trait_levels_onscreen_name_wh2_dlc10_skill_innate_def_hellebron	Greatest Bride of Khaine	true
character_trait_levels_colour_text_wh2_dlc10_skill_innate_hef_alarielle	As Everqueen of all Asur, Alarielle is leader of Avelorn and Ulthuan’s spiritual head.	true
character_trait_levels_onscreen_name_wh2_dlc10_skill_innate_hef_alarielle	The Radiant	true
character_trait_levels_colour_text_wh2_dlc10_skill_innate_hef_alith_anar	Where Alith Anar stalks, so come the ravens to feast on the carrion in the Shadow King’s wake.	true
character_trait_levels_onscreen_name_wh2_dlc10_skill_innate_hef_alith_anar	Raven Lord	true
character_trait_levels_colour_text_wh2_dlc10_skill_innate_hef_handmaiden_army_0_amateurish	If there's a right way to do something, this one doesn't have the wherewithal to know what it is.	true
character_trait_levels_onscreen_name_wh2_dlc10_skill_innate_hef_handmaiden_army_0_amateurish	Amateurish	true
character_trait_levels_colour_text_wh2_dlc10_skill_innate_hef_handmaiden_army_0_disfavoured	This one is something of an eccentric; their erratic behaviour has upset powerful people, which is seldom a good idea.	true
character_trait_levels_onscreen_name_wh2_dlc10_skill_innate_hef_handmaiden_army_0_disfavoured	Disfavoured	true
character_trait_levels_colour_text_wh2_dlc10_skill_innate_hef_handmaiden_army_0_flat_footed	Don't take this one along if you need to get away quickly… or maybe you should…	true
character_trait_levels_onscreen_name_wh2_dlc10_skill_innate_hef_handmaiden_army_0_flat_footed	Flat-Footed	true
character_trait_levels_colour_text_wh2_dlc10_skill_innate_hef_handmaiden_army_0_inhibited	This one doesn't even relax in their own company, so reserved is their nature.	true
character_trait_levels_onscreen_name_wh2_dlc10_skill_innate_hef_handmaiden_army_0_inhibited	Inhibited	true
character_trait_levels_colour_text_wh2_dlc10_skill_innate_hef_handmaiden_army_0_intolerable	Some things should not have to be endured.	true
character_trait_levels_onscreen_name_wh2_dlc10_skill_innate_hef_handmaiden_army_0_intolerable	Intolerable	true
character_trait_levels_colour_text_wh2_dlc10_skill_innate_hef_handmaiden_army_3_resistant	Action, inaction, change - you name it, this one will work against the prevailing wind.	true
character_trait_levels_onscreen_name_wh2_dlc10_skill_innate_hef_handmaiden_army_3_resistant	Resistant	true
character_trait_levels_colour_text_wh2_dlc10_skill_innate_hef_handmaiden_army_7_crushing	On occasion, throwing the whole nine leagues at the enemy is just the ticket.	true
character_trait_levels_onscreen_name_wh2_dlc10_skill_innate_hef_handmaiden_army_7_crushing	Crushing	true
character_trait_levels_colour_text_wh2_dlc10_skill_innate_hef_handmaiden_army_7_honed	Skills refined and improved upon over time can only increase one's edge over the foe.	true
character_trait_levels_onscreen_name_wh2_dlc10_skill_innate_hef_handmaiden_army_7_honed	Honed	true
character_trait_levels_colour_text_wh2_dlc10_skill_innate_hef_handmaiden_army_7_incendiary	You don't want to be on the wrong side of this one's ire - it's explosive to say the least!	true
character_trait_levels_onscreen_name_wh2_dlc10_skill_innate_hef_handmaiden_army_7_incendiary	Incendiary	true
character_trait_levels_colour_text_wh2_dlc10_skill_innate_hef_handmaiden_battle_3_hale_and_hearty	The very picture of good health. Clearly, there's many years still ahead of them.	true
character_trait_levels_onscreen_name_wh2_dlc10_skill_innate_hef_handmaiden_battle_3_hale_and_hearty	Hale & Hearty	true
character_trait_levels_colour_text_wh2_dlc10_skill_innate_hef_handmaiden_battle_3_primed	Every fibre of their being is charged and ready for action - wherever, whenever.	true
character_trait_levels_onscreen_name_wh2_dlc10_skill_innate_hef_handmaiden_battle_3_primed	Primed	true
character_trait_levels_colour_text_wh2_dlc10_skill_innate_hef_handmaiden_battle_3_spry	Impressively energetic for a thousand years old - even by their own reckoning.	true
character_trait_levels_onscreen_name_wh2_dlc10_skill_innate_hef_handmaiden_battle_3_spry	Spry	true
character_trait_levels_colour_text_wh2_dlc10_skill_innate_hef_handmaiden_battle_7_resilient	Armour is just a formality when you're as hard as nails and as tough as old boots.	true
character_trait_levels_onscreen_name_wh2_dlc10_skill_innate_hef_handmaiden_battle_7_resilient	Resilient	true
character_trait_levels_colour_text_wh2_dlc10_skill_innate_hef_handmaiden_battle_7_vigorous	This one is not at all easy to kill, and many have tried, believe me.	true
character_trait_levels_onscreen_name_wh2_dlc10_skill_innate_hef_handmaiden_battle_7_vigorous	Vigorous	true
character_trait_levels_colour_text_wh2_dlc10_skill_innate_hef_handmaiden_campaign_0_divisive	Hmmm interesting. I do wonder if there's a third way, however…	true
character_trait_levels_onscreen_name_wh2_dlc10_skill_innate_hef_handmaiden_campaign_0_divisive	Divisive	true
character_trait_levels_colour_text_wh2_dlc10_skill_innate_hef_handmaiden_campaign_0_frigid	Stiff, starched, formal. Inflexible.	true
character_trait_levels_onscreen_name_wh2_dlc10_skill_innate_hef_handmaiden_campaign_0_frigid	Frigid	true
character_trait_levels_colour_text_wh2_dlc10_skill_innate_hef_handmaiden_campaign_0_incompetent	There's usually a right way and a wrong way to do anything. This one generally gets it wrong.	true
character_trait_levels_onscreen_name_wh2_dlc10_skill_innate_hef_handmaiden_campaign_0_incompetent	Incompetent	true
character_trait_levels_colour_text_wh2_dlc10_skill_innate_hef_handmaiden_campaign_0_meddler	This one can never leave something alone. They always have to meddle.	true
character_trait_levels_onscreen_name_wh2_dlc10_skill_innate_hef_handmaiden_campaign_0_meddler	Meddler	true
character_trait_levels_colour_text_wh2_dlc10_skill_innate_hef_handmaiden_campaign_3_advocate	Good ideas oft-times need vocal, public support to turn them into reality.	true
character_trait_levels_onscreen_name_wh2_dlc10_skill_innate_hef_handmaiden_campaign_3_advocate	Advocate	true
character_trait_levels_colour_text_wh2_dlc10_skill_innate_hef_handmaiden_campaign_3_attentive	The Daemon is very definitely in the detail…	true
character_trait_levels_onscreen_name_wh2_dlc10_skill_innate_hef_handmaiden_campaign_3_attentive	Attentive	true
character_trait_levels_colour_text_wh2_dlc10_skill_innate_hef_handmaiden_campaign_3_healer	Armies can be mended as surely as people can, up to a point of course.	true
character_trait_levels_onscreen_name_wh2_dlc10_skill_innate_hef_handmaiden_campaign_3_healer	Healer	true
character_trait_levels_colour_text_wh2_dlc10_skill_innate_hef_handmaiden_campaign_3_prudent	This one acts not for themselves but the for the greater good, in defence of the future.	true
character_trait_levels_onscreen_name_wh2_dlc10_skill_innate_hef_handmaiden_campaign_3_prudent	Prudent	true
character_trait_levels_colour_text_wh2_dlc10_skill_innate_hef_handmaiden_campaign_3_thinker	Fortunately, there are some who really apply themselves to the problems of the world. Just as well, otherwise we'd be… Oh wait...	true
character_trait_levels_onscreen_name_wh2_dlc10_skill_innate_hef_handmaiden_campaign_3_thinker	Thinker	true
character_trait_levels_colour_text_wh2_dlc10_skill_innate_hef_handmaiden_campaign_7_entrepreneur	There's always a way - always an angle. You just have to find it.	true
character_trait_levels_onscreen_name_wh2_dlc10_skill_innate_hef_handmaiden_campaign_7_entrepreneur	Entrepreneur	true
character_trait_levels_colour_text_wh2_dlc10_skill_innate_hef_handmaiden_campaign_7_fecund	Never short of new ideas, or new ways of looking at old problems.	true
character_trait_levels_onscreen_name_wh2_dlc10_skill_innate_hef_handmaiden_campaign_7_fecund	Fecund	true
character_trait_levels_colour_text_wh2_dlc10_skill_innate_hef_handmaiden_campaign_7_genius	An individual of exceptional skill and worth; the very embodiment of sagacity.	true
character_trait_levels_onscreen_name_wh2_dlc10_skill_innate_hef_handmaiden_campaign_7_genius	Genius	true
character_trait_levels_colour_text_wh2_dlc10_skill_innate_hef_handmaiden_campaign_7_medic	I see something wrong and I fix it with my hands.	true
character_trait_levels_onscreen_name_wh2_dlc10_skill_innate_hef_handmaiden_campaign_7_medic	Medic	true
character_trait_levels_colour_text_wh2_dlc11_skill_cst_innate_admiral_tech_01	Definitely one to watch and perhaps align yourself with.	true
character_trait_levels_onscreen_name_wh2_dlc11_skill_cst_innate_admiral_tech_01	Leadership Qualities	true
character_trait_levels_colour_text_wh2_dlc11_skill_cst_innate_admiral_tech_02	This one has a certain… energy and enthusiasm for the life, which is proving to be infectious.	true
character_trait_levels_onscreen_name_wh2_dlc11_skill_cst_innate_admiral_tech_02	Inspiring Vigour	true
character_trait_levels_colour_text_wh2_dlc11_skill_cst_innate_admiral_tech_03	Years at sea have clearly paid off - this one can clearly 'walk the walk', which has found favour with their crew.	true
character_trait_levels_onscreen_name_wh2_dlc11_skill_cst_innate_admiral_tech_03	Impressive Seacraft	true
character_trait_levels_colour_text_wh2_dlc11_skill_cst_innate_admiral_tech_04	People don't even speak in hushed tones anymore, such is this one's renown.	true
character_trait_levels_onscreen_name_wh2_dlc11_skill_cst_innate_admiral_tech_04	Legendary Status	true
character_trait_levels_colour_text_wh2_dlc11_skill_innate_cst_aranessa	Aranessa Saltspite is the most feared pirate in all of Sartosa, but none fear her more than the Norscan curs she hunts.	true
character_trait_levels_onscreen_name_wh2_dlc11_skill_innate_cst_aranessa	Queen of Tides	true
character_trait_levels_colour_text_wh2_dlc11_skill_innate_cst_arsonist	Beautiful and innocent it may be, but all will be consumed by fire in the end. It is written.	true
character_trait_levels_onscreen_name_wh2_dlc11_skill_innate_cst_arsonist	Firestarter	true
character_trait_levels_colour_text_wh2_dlc11_skill_innate_cst_cylostra	Cylostra is a vengeful spirit intent on performing for the Phoenix King, willing to sink all of Ulthuan to achieve her undying goal.	true
character_trait_levels_onscreen_name_wh2_dlc11_skill_innate_cst_cylostra	Siren of the Storm	true
character_trait_levels_colour_text_wh2_dlc11_skill_innate_cst_damned_paladin	You'd think there wasn't much further to fall, but you'd be wrong - it's a long, long way down to Stromfels' Chest, after all…	true
character_trait_levels_onscreen_name_wh2_dlc11_skill_innate_cst_damned_paladin	Fallen from Grace	true
character_trait_levels_colour_text_wh2_dlc11_skill_innate_cst_harkon	Luthor Harkon has made many great cold-blooded enemies in his time, but his Undead army fear - and feel - nothing.	true
character_trait_levels_onscreen_name_wh2_dlc11_skill_innate_cst_harkon	Arch Grand Commodore	true
character_trait_levels_colour_text_wh2_dlc11_skill_innate_cst_looter	How else is an ordinary, decent pirate to make an honest living in these hard, dark times?	true
character_trait_levels_onscreen_name_wh2_dlc11_skill_innate_cst_looter	Plunderer	true
character_trait_levels_colour_text_wh2_dlc11_skill_innate_cst_murderer	Killing is at the forefront of this one's mind. Hopefully, they also know how to run a ship.	true
character_trait_levels_onscreen_name_wh2_dlc11_skill_innate_cst_murderer	Murderer	true
character_trait_levels_colour_text_wh2_dlc11_skill_innate_cst_noctilus	Count Noctilus abandoned Sylvania to become the captain of the Dreadfleet and master of the Galleon's Graveyard; he is the foremost bringer of death upon the high seas.	true
character_trait_levels_onscreen_name_wh2_dlc11_skill_innate_cst_noctilus	Lord of Dread	true
character_trait_levels_colour_text_wh2_dlc11_skill_innate_cst_ringleader	It takes more than mere muscle to be leader, you must also know how to make money and how to inflict pain - a lot of pain.	true
character_trait_levels_onscreen_name_wh2_dlc11_skill_innate_cst_ringleader	Instigator	true
character_trait_levels_colour_text_wh2_dlc11_skill_innate_cst_schemer	There's nothing quite like a good, straightforward plan - and this is nothing like one! Complexity rarely trumps simplicity, in all matters.	true
character_trait_levels_onscreen_name_wh2_dlc11_skill_innate_cst_schemer	Intrigant	true
character_trait_levels_colour_text_wh2_dlc11_skill_innate_cst_smuggler	Be the cargo powder, steel, gold or flesh, in the final analysis it matters not.	true
character_trait_levels_onscreen_name_wh2_dlc11_skill_innate_cst_smuggler	Smuggler	true
character_trait_levels_colour_text_wh2_dlc11_skill_innate_def_lokhir	The greatest Corsair since the time of his illustrious grandfather, Lokhir is doing the name of Fellheart proud in every sense.	true
character_trait_levels_onscreen_name_wh2_dlc11_skill_innate_def_lokhir	Krakenlord	true
character_trait_levels_colour_text_wh2_main_skill_innate_all_aggressive	If you're gonna die, you may as well die with your boots on.	true
character_trait_levels_onscreen_name_wh2_main_skill_innate_all_aggressive	Aggressive	true
character_trait_levels_colour_text_wh2_main_skill_innate_all_confident	Self-belief is a fine thing when not misplaced.	true
character_trait_levels_onscreen_name_wh2_main_skill_innate_all_confident	Confident	true
character_trait_levels_colour_text_wh2_main_skill_innate_all_cunning	Deceit is a perfectly acceptable means of attack.	true
character_trait_levels_onscreen_name_wh2_main_skill_innate_all_cunning	Cunning	true
character_trait_levels_colour_text_wh2_main_skill_innate_all_determined	Having a modicum of resolve is useful in a world that continually tests it.	true
character_trait_levels_onscreen_name_wh2_main_skill_innate_all_determined	Determined	true
character_trait_levels_colour_text_wh2_main_skill_innate_all_disciplined	Always in control, this one leaves no stone unturned and nothing to chance.	true
character_trait_levels_onscreen_name_wh2_main_skill_innate_all_disciplined	Disciplined	true
character_trait_levels_colour_text_wh2_main_skill_innate_all_fleet_footed	Being fleet of foot is useful in a fight… or when trying to get away afterwards!	true
character_trait_levels_onscreen_name_wh2_main_skill_innate_all_fleet_footed	Fleet-Footed	true
character_trait_levels_colour_text_wh2_main_skill_innate_all_intelligent	Sharp minds make sharp blades sharper still.	true
character_trait_levels_onscreen_name_wh2_main_skill_innate_all_intelligent	Intelligent	true
character_trait_levels_colour_text_wh2_main_skill_innate_all_knowledgeable	What this being doesn't know probably isn't worth knowing, so deep is their interest in the world and its ways.	true
character_trait_levels_onscreen_name_wh2_main_skill_innate_all_knowledgeable	Knowledgeable	true
character_trait_levels_colour_text_wh2_main_skill_innate_all_perceptive	Although actually reading minds is not in their skillset, this one has extraordinary insight into the motives of others.	true
character_trait_levels_onscreen_name_wh2_main_skill_innate_all_perceptive	Perceptive	true
character_trait_levels_colour_text_wh2_main_skill_innate_all_strategist	This being has a plan - not just a game plan, but a master plan to achieve their long-term aims.	true
character_trait_levels_onscreen_name_wh2_main_skill_innate_all_strategist	Strategist	true
character_trait_levels_colour_text_wh2_main_skill_innate_all_strong	Well built, robust. Powerful.	true
character_trait_levels_onscreen_name_wh2_main_skill_innate_all_strong	Strong	true
character_trait_levels_colour_text_wh2_main_skill_innate_all_tactician	Careful planning, knowledge of the terrain and the weaknesses of the enemy are the key to victory.	true
character_trait_levels_onscreen_name_wh2_main_skill_innate_all_tactician	Tactician	true
character_trait_levels_colour_text_wh2_main_skill_innate_all_tough	Rugged, resistant, and almost unbreakable, this being can and will take on all comers.	true
character_trait_levels_onscreen_name_wh2_main_skill_innate_all_tough	Tough	true
character_trait_levels_colour_text_wh2_main_skill_innate_all_weapon_master	If you can swing, slash, stab, gouge, or shoot it, this warrior has mastered every aspect of its use.	true
character_trait_levels_onscreen_name_wh2_main_skill_innate_all_weapon_master	Weapon Master	true
character_trait_levels_colour_text_wh2_main_skill_innate_bst_booze_cravings	Some beings just don't know when to put the bottle down.	true
character_trait_levels_onscreen_name_wh2_main_skill_innate_bst_booze_cravings	Booze Cravings	true
character_trait_levels_colour_text_wh2_main_skill_innate_bst_khornes_fury	More than mere bloodlust, this one is filled with the primal, Ruinous rage of the Lord of Battle.	true
character_trait_levels_onscreen_name_wh2_main_skill_innate_bst_khornes_fury	Khorne's Fury	true
character_trait_levels_colour_text_wh2_main_skill_innate_bst_nurgles_foul_stink	This one has something of the compost heap about them…	true
character_trait_levels_onscreen_name_wh2_main_skill_innate_bst_nurgles_foul_stink	Nurgle's Foul Stink	true
character_trait_levels_colour_text_wh2_main_skill_innate_bst_torment_utterances	The Dark Tongue is an apt medium through which to torment, mock and enrage the foe.	true
character_trait_levels_onscreen_name_wh2_main_skill_innate_bst_torment_utterances	Torment Utterances	true
character_trait_levels_colour_text_wh2_main_skill_innate_bst_unsated_bloodthirst	Sometimes, letting so much blood that the soil itself is stained just isn't enough. And it will never be.	true
character_trait_levels_onscreen_name_wh2_main_skill_innate_bst_unsated_bloodthirst	Unsated Bloodthirst	true
character_trait_levels_colour_text_wh2_main_skill_innate_chs_diabolic_spendour	Oh, horrific wonder! Vile awe! Such hateful majesty!	true
character_trait_levels_onscreen_name_wh2_main_skill_innate_chs_diabolic_spendour	Diabolic Splendour 	true
character_trait_levels_colour_text_wh2_main_skill_innate_chs_dominance	"Mine desire is all, mortal wretch!"	true
character_trait_levels_onscreen_name_wh2_main_skill_innate_chs_dominance	Infernal Dominance 	true
character_trait_levels_colour_text_wh2_main_skill_innate_def_cruel	To cause another's suffering, to delight in their pain, to extend their agony according to your whim. That is power.	true
character_trait_levels_onscreen_name_wh2_main_skill_innate_def_cruel	Cruel	true
character_trait_levels_colour_text_wh2_main_skill_innate_def_malekith	The Witch King long ago sought to take Ulthuan's crown, but the Flames of Asuryan left him twisted with hatred and horribly scarred.	true
character_trait_levels_onscreen_name_wh2_main_skill_innate_def_malekith	Witch King of Naggaroth	true
character_trait_levels_colour_text_wh2_main_skill_innate_def_malevolent	Evil-minded, poisonous malignancy. For its own sake.	true
character_trait_levels_onscreen_name_wh2_main_skill_innate_def_malevolent	Malevolent	true
character_trait_levels_colour_text_wh2_main_skill_innate_def_malicious	When this one is abroad you can be sure that malice is borne towards anyone and everyone.	true
character_trait_levels_onscreen_name_wh2_main_skill_innate_def_malicious	Malicious	true
character_trait_levels_colour_text_wh2_main_skill_innate_def_morathi	"I would be so grateful for your cooperation in this, my lord. I do so hate to be... disappointed."	true
character_trait_levels_onscreen_name_wh2_main_skill_innate_def_morathi	Dark Manipulator	true
character_trait_levels_colour_text_wh2_main_skill_innate_def_spiteful	Behind every thought they have - and every deed - is shameless, full-blooded spite.	true
character_trait_levels_onscreen_name_wh2_main_skill_innate_def_spiteful	Spiteful	true
character_trait_levels_colour_text_wh2_main_skill_innate_def_vicious	"Some folk call me vicious. I'll scoop out the eyes of any who utter it in my presence."	true
character_trait_levels_onscreen_name_wh2_main_skill_innate_def_vicious	Vicious	true
character_trait_levels_colour_text_wh2_main_skill_innate_dwf_ancestral_blood_grimnir	This brave Dawi can trace his lineage back to Grimnir, the Warrior-God.	true
character_trait_levels_onscreen_name_wh2_main_skill_innate_dwf_ancestral_blood_grimnir	Ancestral Blood - Grimnir	true
character_trait_levels_colour_text_wh2_main_skill_innate_dwf_ancestral_blood_grungni	This industrious Dawi can trace his lineage back to Grungni, God of Mines and Smiths.	true
character_trait_levels_onscreen_name_wh2_main_skill_innate_dwf_ancestral_blood_grungni	Ancestral Blood - Grungni	true
character_trait_levels_colour_text_wh2_main_skill_innate_dwf_ancestral_blood_valaya	This loyal Dawi can trace his lineage back to Valaya, Goddess of Healing and Protection.	true
character_trait_levels_onscreen_name_wh2_main_skill_innate_dwf_ancestral_blood_valaya	Ancestral Blood - Valaya	true
character_trait_levels_colour_text_wh2_main_skill_innate_emp_imperious	Franz has put his trust in this man; pray he does not let him down!	true
character_trait_levels_onscreen_name_wh2_main_skill_innate_emp_imperious	Imperious	true
character_trait_levels_colour_text_wh2_main_skill_innate_emp_monster_hunter	The thrill of the chase, the tremor as the quarry is cornered, the ecstasy of the kill. These are the things that matter.	true
character_trait_levels_onscreen_name_wh2_main_skill_innate_emp_monster_hunter	Monster Hunter	true
character_trait_levels_colour_text_wh2_main_skill_innate_emp_monster_tracker	"If it's got a scent and footprints, I'll find it. Also, it helps if it's absolutely huge and can be spotted a league away."	true
character_trait_levels_onscreen_name_wh2_main_skill_innate_emp_monster_tracker	Monster Tracker 	true
character_trait_levels_colour_text_wh2_main_skill_innate_emp_noble	"The smallfolk should be thankful - without us, who would they work for?"	true
character_trait_levels_onscreen_name_wh2_main_skill_innate_emp_noble	Noble 	true
character_trait_levels_colour_text_wh2_main_skill_innate_emp_regal	A regal air? Let's see how long that lasts.	true
character_trait_levels_onscreen_name_wh2_main_skill_innate_emp_regal	Regal 	true
character_trait_levels_colour_text_wh2_main_skill_innate_grn_big_bully	"Someday he's gonna be a Boss. Can you believe someday we'll work for 'im?"	true
character_trait_levels_onscreen_name_wh2_main_skill_innate_grn_big_bully	Big Bully	true
character_trait_levels_colour_text_wh2_main_skill_innate_grn_bragga	When you're clearly betterer than all the uvvers you need to shout the loudest, so everybody else knows you're the betterest.	true
character_trait_levels_onscreen_name_wh2_main_skill_innate_grn_bragga	Bragga	true
character_trait_levels_colour_text_wh2_main_skill_innate_grn_mushroom_addicted	"Dat a 'shroom in yer pouch? Give it! Give it to me!"	true
character_trait_levels_onscreen_name_wh2_main_skill_innate_grn_mushroom_addicted	Mushroom-Addicted	true
character_trait_levels_colour_text_wh2_main_skill_innate_grn_serial_danca	You can't keep a good 'danca' down, especially when those drums start bangin'!	true
character_trait_levels_onscreen_name_wh2_main_skill_innate_grn_serial_danca	Serial Danca	true
character_trait_levels_colour_text_wh2_main_skill_innate_grn_tortura	When a Warboss needs someone to talk, he calls on this "Boy wiv da extra pointy sticks".	true
character_trait_levels_onscreen_name_wh2_main_skill_innate_grn_tortura	Tortura	true
character_trait_levels_colour_text_wh2_main_skill_innate_hef_alastar_the_white_lion	The white lion's pelt worn by Lord Alastar bears inspiring testament to his great heart and dauntless courage.	true
character_trait_levels_onscreen_name_wh2_main_skill_innate_hef_alastar_the_white_lion	Lion of Chrace	true
character_trait_levels_colour_text_wh2_main_skill_innate_hef_loremaster_army_0_disfavoured	This one is something of an eccentric; their erratic behaviour has upset powerful people, which is seldom a good idea.	true
character_trait_levels_onscreen_name_wh2_main_skill_innate_hef_loremaster_army_0_disfavoured	Disfavoured	true
character_trait_levels_colour_text_wh2_main_skill_innate_hef_loremaster_army_0_flat_footed	Don't take this one along if you need to get away quickly… or maybe you should…	true
character_trait_levels_onscreen_name_wh2_main_skill_innate_hef_loremaster_army_0_flat_footed	Flat-Footed	true
character_trait_levels_colour_text_wh2_main_skill_innate_hef_loremaster_army_0_shivery	"Look, it's terribly cold. Can we get those things as far away from me as possible? Yes, that's right - on the flank."	true
character_trait_levels_onscreen_name_wh2_main_skill_innate_hef_loremaster_army_0_shivery	Shivery	true
character_trait_levels_colour_text_wh2_main_skill_innate_hef_loremaster_army_3_fit	The very illustration of Elven perfection. What a git!	true
character_trait_levels_onscreen_name_wh2_main_skill_innate_hef_loremaster_army_3_fit	Fit	true
character_trait_levels_colour_text_wh2_main_skill_innate_hef_loremaster_army_3_stimulated	The prospect of battle fills the phoenix with a brisk energy that's somewhat infectious...	true
character_trait_levels_onscreen_name_wh2_main_skill_innate_hef_loremaster_army_3_stimulated	Stimulated	true
character_trait_levels_colour_text_wh2_main_skill_innate_hef_loremaster_army_3_well_known	Through his words and deeds, this one has made a name for himself within noble Elven circles.	true
character_trait_levels_onscreen_name_wh2_main_skill_innate_hef_loremaster_army_3_well_known	Widely Known	true
character_trait_levels_colour_text_wh2_main_skill_innate_hef_loremaster_army_7_athletic	Even for a long-limbed, long-lived Elf, this character is a fine specimen.	true
character_trait_levels_onscreen_name_wh2_main_skill_innate_hef_loremaster_army_7_athletic	Athletic	true
character_trait_levels_colour_text_wh2_main_skill_innate_hef_loremaster_army_7_bladelord	"Enlightenment is achieved by mastering not only the body, but the soul. Only then can a warrior truly understand the value of life."	true
character_trait_levels_onscreen_name_wh2_main_skill_innate_hef_loremaster_army_7_bladelord	Bladelord	true
character_trait_levels_colour_text_wh2_main_skill_innate_hef_loremaster_army_7_exhilerated	"Battle, you say? Today? Marvellous! Bring me my phoenix - let's get killing!"	true
character_trait_levels_onscreen_name_wh2_main_skill_innate_hef_loremaster_army_7_exhilerated	Exhilarated	true
character_trait_levels_colour_text_wh2_main_skill_innate_hef_loremaster_battle_0_feeble	It's surprising that this one can even lift a pen, let alone a sword.	true
character_trait_levels_onscreen_name_wh2_main_skill_innate_hef_loremaster_battle_0_feeble	Feeble	true
character_trait_levels_colour_text_wh2_main_skill_innate_hef_loremaster_battle_0_mooncalf	"There are people living inside Morrslieb - right inside, yes - and they want to take over the world!"	true
character_trait_levels_onscreen_name_wh2_main_skill_innate_hef_loremaster_battle_0_mooncalf	Mooncalf	true
character_trait_levels_colour_text_wh2_main_skill_innate_hef_loremaster_battle_0_squishy	Some warriors are like rocks - hard and immovable. This one is like jelly…	true
character_trait_levels_onscreen_name_wh2_main_skill_innate_hef_loremaster_battle_0_squishy	Squishy	true
character_trait_levels_colour_text_wh2_main_skill_innate_hef_loremaster_battle_3_elusive	This one moves like lightning, ducking and twisting to avoid their opponent's blows.	true
character_trait_levels_onscreen_name_wh2_main_skill_innate_hef_loremaster_battle_3_elusive	Elusive	true
character_trait_levels_colour_text_wh2_main_skill_innate_hef_loremaster_battle_3_fortuitous	Chance is like magic - it can be harnessed to the individual's will.	true
character_trait_levels_onscreen_name_wh2_main_skill_innate_hef_loremaster_battle_3_fortuitous	Fortuitous	true
character_trait_levels_colour_text_wh2_main_skill_innate_hef_loremaster_battle_3_primed	Every fibre of their being is charged and ready for action - wherever, whenever.	true
character_trait_levels_onscreen_name_wh2_main_skill_innate_hef_loremaster_battle_3_primed	Primed	true
character_trait_levels_colour_text_wh2_main_skill_innate_hef_loremaster_battle_7_conductor	Through their veins a charge is racing. Energy, filling the ominous void within.	true
character_trait_levels_onscreen_name_wh2_main_skill_innate_hef_loremaster_battle_7_conductor	Conductor	true
character_trait_levels_colour_text_wh2_main_skill_innate_hef_loremaster_battle_7_protected	"If you need anything, there are guards outside the doors. Many guards."	true
character_trait_levels_onscreen_name_wh2_main_skill_innate_hef_loremaster_battle_7_protected	Protected	true
character_trait_levels_colour_text_wh2_main_skill_innate_hef_loremaster_battle_7_resilient	Armour is just a formality when you're as hard as nails and as tough as old boots.	true
character_trait_levels_onscreen_name_wh2_main_skill_innate_hef_loremaster_battle_7_resilient	Resilient	true
character_trait_levels_colour_text_wh2_main_skill_innate_hef_loremaster_campaign_0_deviant	In society, one must learn to conform. Or not, as the case may be…	true
character_trait_levels_onscreen_name_wh2_main_skill_innate_hef_loremaster_campaign_0_deviant	Deviant	true
character_trait_levels_colour_text_wh2_main_skill_innate_hef_loremaster_campaign_0_frigid	Stiff, starched, formal. Inflexible.	true
character_trait_levels_onscreen_name_wh2_main_skill_innate_hef_loremaster_campaign_0_frigid	Frigid	true
character_trait_levels_colour_text_wh2_main_skill_innate_hef_loremaster_campaign_0_rebel	A subversive agitator, and clinically non-conformist to boot.	true
character_trait_levels_onscreen_name_wh2_main_skill_innate_hef_loremaster_campaign_0_rebel	Rebel	true
character_trait_levels_colour_text_wh2_main_skill_innate_hef_loremaster_campaign_3_advocate	Good ideas oft-times need vocal, public support to turn them into reality.	true
character_trait_levels_onscreen_name_wh2_main_skill_innate_hef_loremaster_campaign_3_advocate	Advocate	true
character_trait_levels_colour_text_wh2_main_skill_innate_hef_loremaster_campaign_3_fruitful	Industrious and productive, this one can turn ideas into gold - sometimes literally.	true
character_trait_levels_onscreen_name_wh2_main_skill_innate_hef_loremaster_campaign_3_fruitful	Fruitful	true
character_trait_levels_colour_text_wh2_main_skill_innate_hef_loremaster_campaign_3_healer	Armies can be mended as surely as people can, up to a point of course.	true
character_trait_levels_onscreen_name_wh2_main_skill_innate_hef_loremaster_campaign_3_healer	Healer	true
character_trait_levels_colour_text_wh2_main_skill_innate_hef_loremaster_campaign_7_disciple	This one is happy to follow and let other, more energetic types, lead from the front.	true
character_trait_levels_onscreen_name_wh2_main_skill_innate_hef_loremaster_campaign_7_disciple	Disciple	true
character_trait_levels_colour_text_wh2_main_skill_innate_hef_loremaster_campaign_7_fecund	Never short of new ideas, or new ways of looking at old problems.	true
character_trait_levels_onscreen_name_wh2_main_skill_innate_hef_loremaster_campaign_7_fecund	Fecund	true
character_trait_levels_colour_text_wh2_main_skill_innate_hef_loremaster_campaign_7_medic	"I see something wrong and I fix it with my hands."	true
character_trait_levels_onscreen_name_wh2_main_skill_innate_hef_loremaster_campaign_7_medic	Medic	true
character_trait_levels_colour_text_wh2_main_skill_innate_hef_mage_army_0_flustered	Cool, calm, and collected. Yeah, right!	true
character_trait_levels_onscreen_name_wh2_main_skill_innate_hef_mage_army_0_flustered	Flustered	true
character_trait_levels_colour_text_wh2_main_skill_innate_hef_mage_army_0_inhibited	This one doesn't even relax in their own company, so reserved is their nature.	true
character_trait_levels_onscreen_name_wh2_main_skill_innate_hef_mage_army_0_inhibited	Inhibited	true
character_trait_levels_colour_text_wh2_main_skill_innate_hef_mage_army_0_wet	Fortitude? Strength of character? Do me a favour - this yellow-bellied poltroon has none.	true
character_trait_levels_onscreen_name_wh2_main_skill_innate_hef_mage_army_0_wet	Ridiculed	true
character_trait_levels_colour_text_wh2_main_skill_innate_hef_mage_army_3_dampener	Definitely not the life and soul of the party; they exude melancholy and depression.	true
character_trait_levels_onscreen_name_wh2_main_skill_innate_hef_mage_army_3_dampener	Dampener	true
character_trait_levels_colour_text_wh2_main_skill_innate_hef_mage_army_3_flammable	Tempers, like wicks, can be ignited. Watch the anger burn.	true
character_trait_levels_onscreen_name_wh2_main_skill_innate_hef_mage_army_3_flammable	Flammable	true
character_trait_levels_colour_text_wh2_main_skill_innate_hef_mage_army_3_resistant	Action, inaction, change - you name it, this one will work against the prevailing wind.	true
character_trait_levels_onscreen_name_wh2_main_skill_innate_hef_mage_army_3_resistant	Resistant	true
character_trait_levels_colour_text_wh2_main_skill_innate_hef_mage_army_7_incendiary	You don't want to be on the wrong side of this one's ire - it's explosive to say the least!	true
character_trait_levels_onscreen_name_wh2_main_skill_innate_hef_mage_army_7_incendiary	Incendiary	true
character_trait_levels_colour_text_wh2_main_skill_innate_hef_mage_army_7_negator	Not every cloud has a silver lining.	true
character_trait_levels_onscreen_name_wh2_main_skill_innate_hef_mage_army_7_negator	Negator	true
character_trait_levels_colour_text_wh2_main_skill_innate_hef_mage_army_7_protective	Whatever quality is needed to stand guard over the Asur way of life, this one has it in abundance.	true
character_trait_levels_onscreen_name_wh2_main_skill_innate_hef_mage_army_7_protective	Protective	true
character_trait_levels_colour_text_wh2_main_skill_innate_hef_mage_battle_0_enervated	If ever there was a candidate for a relaxing break at an all-inclusive spa, it was this one.	true
character_trait_levels_onscreen_name_wh2_main_skill_innate_hef_mage_battle_0_enervated	Enervated	true
character_trait_levels_colour_text_wh2_main_skill_innate_hef_mage_battle_0_peaky	Looking "not too well" has become a permanent condition. Clearly, they're lacking essential herbs.	true
character_trait_levels_onscreen_name_wh2_main_skill_innate_hef_mage_battle_0_peaky	Peaky	true
character_trait_levels_colour_text_wh2_main_skill_innate_hef_mage_battle_0_uni_ped	They say two are better than one. They are, of course, totally wrong in every respect.	true
character_trait_levels_onscreen_name_wh2_main_skill_innate_hef_mage_battle_0_uni_ped	Uniped	true
character_trait_levels_colour_text_wh2_main_skill_innate_hef_mage_battle_3_fortuitous	Chance is like magic - it can be harnessed to the individual's will.	true
character_trait_levels_onscreen_name_wh2_main_skill_innate_hef_mage_battle_3_fortuitous	Fortuitous	true
character_trait_levels_colour_text_wh2_main_skill_innate_hef_mage_battle_3_primed	Every fibre of their being is charged and ready for action - wherever, whenever.	true
character_trait_levels_onscreen_name_wh2_main_skill_innate_hef_mage_battle_3_primed	Primed	true
character_trait_levels_colour_text_wh2_main_skill_innate_hef_mage_battle_3_spry	Impressively energetic for a thousand years old - even by their own reckoning.	true
character_trait_levels_onscreen_name_wh2_main_skill_innate_hef_mage_battle_3_spry	Spry	true
character_trait_levels_colour_text_wh2_main_skill_innate_hef_mage_battle_7_conductor	Through their veins a charge is racing. Energy, filling the ominous void within.	true
character_trait_levels_onscreen_name_wh2_main_skill_innate_hef_mage_battle_7_conductor	Conductor	true
character_trait_levels_colour_text_wh2_main_skill_innate_hef_mage_battle_7_limber	"Staying this supple takes effort. You don’t get definition like that by sitting about and drinking."	true
character_trait_levels_onscreen_name_wh2_main_skill_innate_hef_mage_battle_7_limber	Limber	true
character_trait_levels_colour_text_wh2_main_skill_innate_hef_mage_battle_7_protected	"If you need anything, there are guards outside the doors. Many guards."	true
character_trait_levels_onscreen_name_wh2_main_skill_innate_hef_mage_battle_7_protected	Protected	true
character_trait_levels_colour_text_wh2_main_skill_innate_hef_mage_campaign_0_incompetent	There's usually a right way and a wrong way to do anything. This one generally gets it wrong.	true
character_trait_levels_onscreen_name_wh2_main_skill_innate_hef_mage_campaign_0_incompetent	Incompetent	true
character_trait_levels_colour_text_wh2_main_skill_innate_hef_mage_campaign_0_luddite	Machinery - and indeed progress of any kind - is anathema to this one, because there's no substitute for good, honest toil.	true
character_trait_levels_onscreen_name_wh2_main_skill_innate_hef_mage_campaign_0_luddite	Luddite	true
character_trait_levels_colour_text_wh2_main_skill_innate_hef_mage_campaign_0_meddler	This one can never leave something alone. They always have to meddle.	true
character_trait_levels_onscreen_name_wh2_main_skill_innate_hef_mage_campaign_0_meddler	Meddler	true
character_trait_levels_colour_text_wh2_main_skill_innate_hef_mage_campaign_3_builder	Much of the Ulthuan skyline built over the last thousand years is down to this one’s sterling endeavours.	true
character_trait_levels_onscreen_name_wh2_main_skill_innate_hef_mage_campaign_3_builder	Builder	true
character_trait_levels_colour_text_wh2_main_skill_innate_hef_mage_campaign_3_dealer	"Too late, too late!" will be the cry, when the one with the bargains passes you by.	true
character_trait_levels_onscreen_name_wh2_main_skill_innate_hef_mage_campaign_3_dealer	Dealer	true
character_trait_levels_colour_text_wh2_main_skill_innate_hef_mage_campaign_3_thinker	Fortunately, there are some who really apply themselves to the problems of the world. Just as well, otherwise we'd be… Oh wait...	true
character_trait_levels_onscreen_name_wh2_main_skill_innate_hef_mage_campaign_3_thinker	Thinker	true
character_trait_levels_colour_text_wh2_main_skill_innate_hef_mage_campaign_7_administrator	If it requires accuracy and organisation, this one is your Elf. Not so much fun at parties, however.	true
character_trait_levels_onscreen_name_wh2_main_skill_innate_hef_mage_campaign_7_administrator	Administrator	true
character_trait_levels_colour_text_wh2_main_skill_innate_hef_mage_campaign_7_entrepreneur	"There's always a way - always an angle. You just have to find it."	true
character_trait_levels_onscreen_name_wh2_main_skill_innate_hef_mage_campaign_7_entrepreneur	Entrepreneur	true
character_trait_levels_colour_text_wh2_main_skill_innate_hef_mage_campaign_7_genius	An individual of exceptional skill and worth; the very embodiment of sagacity.	true
character_trait_levels_onscreen_name_wh2_main_skill_innate_hef_mage_campaign_7_genius	Genius	true
character_trait_levels_colour_text_wh2_main_skill_innate_hef_noble_army_0_amateurish	If there's a right way to do something, this one doesn't have the wherewithal to know what it is.	true
character_trait_levels_onscreen_name_wh2_main_skill_innate_hef_noble_army_0_amateurish	Amateurish	true
character_trait_levels_colour_text_wh2_main_skill_innate_hef_noble_army_0_intolerable	Some things should not have to be endured.	true
character_trait_levels_onscreen_name_wh2_main_skill_innate_hef_noble_army_0_intolerable	Intolerable	true
character_trait_levels_colour_text_wh2_main_skill_innate_hef_noble_army_0_petrified	This one doesn't have the stomach for intrigue, let alone war and its privations.	true
character_trait_levels_onscreen_name_wh2_main_skill_innate_hef_noble_army_0_petrified	Petrified	true
character_trait_levels_colour_text_wh2_main_skill_innate_hef_noble_army_3_motivator	Self-starting is a useful ability; starting others - and keeping them that way - more useful still.	true
character_trait_levels_onscreen_name_wh2_main_skill_innate_hef_noble_army_3_motivator	Motivator	true
character_trait_levels_colour_text_wh2_main_skill_innate_hef_noble_army_3_percussive	There's nothing quite so impressive - and painful - as a well-timed, well-ordered charge.	true
character_trait_levels_onscreen_name_wh2_main_skill_innate_hef_noble_army_3_percussive	Percussive	true
character_trait_levels_colour_text_wh2_main_skill_innate_hef_noble_army_3_practiced	Practice really does make perfect, or at least makes it much harder to kill.	true
character_trait_levels_onscreen_name_wh2_main_skill_innate_hef_noble_army_3_practiced	Practiced	true
character_trait_levels_colour_text_wh2_main_skill_innate_hef_noble_army_7_crushing	On occasion, throwing the whole nine leagues at the enemy is just the ticket.	true
character_trait_levels_onscreen_name_wh2_main_skill_innate_hef_noble_army_7_crushing	Crushing	true
character_trait_levels_colour_text_wh2_main_skill_innate_hef_noble_army_7_dynamo	This one is a driving force; potential is taken and transformed into decisive action by their hand.	true
character_trait_levels_onscreen_name_wh2_main_skill_innate_hef_noble_army_7_dynamo	Dynamo	true
character_trait_levels_colour_text_wh2_main_skill_innate_hef_noble_army_7_honed	Skills refined and improved upon over time can only increase one's edge over the foe.	true
character_trait_levels_onscreen_name_wh2_main_skill_innate_hef_noble_army_7_honed	Honed	true
character_trait_levels_colour_text_wh2_main_skill_innate_hef_noble_battle_0_pale_and_wan	It's as much effort as this one can make to lift a blade, let alone swing it at an opponent with force.	true
character_trait_levels_onscreen_name_wh2_main_skill_innate_hef_noble_battle_0_pale_and_wan	Pale & Wan	true
character_trait_levels_colour_text_wh2_main_skill_innate_hef_noble_battle_0_pigeon_chested	Bones are not supposed to be on the outside.	true
character_trait_levels_onscreen_name_wh2_main_skill_innate_hef_noble_battle_0_pigeon_chested	Pigeon-Chested	true
character_trait_levels_colour_text_wh2_main_skill_innate_hef_noble_battle_0_squishy	Some warriors are like rocks - hard and immovable. This one is like jelly…	true
character_trait_levels_onscreen_name_wh2_main_skill_innate_hef_noble_battle_0_squishy	Squishy	true
character_trait_levels_colour_text_wh2_main_skill_innate_hef_noble_battle_3_elusive	This one moves like lightning, ducking and twisting to avoid their opponent's blows.	true
character_trait_levels_onscreen_name_wh2_main_skill_innate_hef_noble_battle_3_elusive	Elusive	true
character_trait_levels_colour_text_wh2_main_skill_innate_hef_noble_battle_3_hale_and_hearty	The very picture of good health. Clearly, there's many years still ahead of them.	true
character_trait_levels_onscreen_name_wh2_main_skill_innate_hef_noble_battle_3_hale_and_hearty	Hale & Hearty	true
character_trait_levels_colour_text_wh2_main_skill_innate_hef_noble_battle_3_trained	Every action is executed seemingly without effort.	true
character_trait_levels_onscreen_name_wh2_main_skill_innate_hef_noble_battle_3_trained	Trained	true
character_trait_levels_colour_text_wh2_main_skill_innate_hef_noble_battle_7_dangerous	You really don't want to be on the receiving end of an attack made by this one. You really don’t.	true
character_trait_levels_onscreen_name_wh2_main_skill_innate_hef_noble_battle_7_dangerous	Dangerous	true
character_trait_levels_colour_text_wh2_main_skill_innate_hef_noble_battle_7_resilient	Armour is just a formality when you're as hard as nails and as tough as old boots.	true
character_trait_levels_onscreen_name_wh2_main_skill_innate_hef_noble_battle_7_resilient	Resilient	true
character_trait_levels_colour_text_wh2_main_skill_innate_hef_noble_battle_7_vigorous	This one is not at all easy to kill, and many have tried, believe me.	true
character_trait_levels_onscreen_name_wh2_main_skill_innate_hef_noble_battle_7_vigorous	Vigorous	true
character_trait_levels_colour_text_wh2_main_skill_innate_hef_noble_campaign_0_divisive	"Hmmm interesting. I do wonder if there's a third way, however…"	true
character_trait_levels_onscreen_name_wh2_main_skill_innate_hef_noble_campaign_0_divisive	Divisive	true
character_trait_levels_colour_text_wh2_main_skill_innate_hef_noble_campaign_0_inattentive	"I'm sorry, what? I was looking at that cloud - looks just like Aenarion in a certain light."	true
character_trait_levels_onscreen_name_wh2_main_skill_innate_hef_noble_campaign_0_inattentive	Inattentive	true
character_trait_levels_colour_text_wh2_main_skill_innate_hef_noble_campaign_0_profligate	Extravagant and dissolute, this one could almost be an honorary Druchii, such is their inclination for excess.	true
character_trait_levels_onscreen_name_wh2_main_skill_innate_hef_noble_campaign_0_profligate	Profligate	true
character_trait_levels_colour_text_wh2_main_skill_innate_hef_noble_campaign_3_attentive	The Daemon is very definitely in the detail…	true
character_trait_levels_onscreen_name_wh2_main_skill_innate_hef_noble_campaign_3_attentive	Attentive	true
character_trait_levels_colour_text_wh2_main_skill_innate_hef_noble_campaign_3_conciliatory	"Come now, let this conflict cease. We're all Asur, remember?"	true
character_trait_levels_onscreen_name_wh2_main_skill_innate_hef_noble_campaign_3_conciliatory	Conciliatory	true
character_trait_levels_colour_text_wh2_main_skill_innate_hef_noble_campaign_3_prudent	This one acts not for themselves but the for the greater good, in defence of the future.	true
character_trait_levels_onscreen_name_wh2_main_skill_innate_hef_noble_campaign_3_prudent	Prudent	true
character_trait_levels_colour_text_wh2_main_skill_innate_hef_noble_campaign_7_conscientious	Whatever the task, this one always wishes to do it to the best of their ability - and better on every occasion thereafter.	true
character_trait_levels_onscreen_name_wh2_main_skill_innate_hef_noble_campaign_7_conscientious	Conscientious	true
character_trait_levels_colour_text_wh2_main_skill_innate_hef_noble_campaign_7_emollient	This one smooths the way, so differing opinions do not so easily lead to frayed tempers and drawn blades.	true
character_trait_levels_onscreen_name_wh2_main_skill_innate_hef_noble_campaign_7_emollient	Emollient	true
character_trait_levels_colour_text_wh2_main_skill_innate_hef_noble_campaign_7_frugal	The best way to hang on to your gold is never to spend any of it.	true
character_trait_levels_onscreen_name_wh2_main_skill_innate_hef_noble_campaign_7_frugal	Frugal	true
character_trait_levels_colour_text_wh2_main_skill_innate_hef_prince_army_0_fay	There's something of the other world about this one; this cruel plane has failed to engage them.	true
character_trait_levels_onscreen_name_wh2_main_skill_innate_hef_prince_army_0_fay	Fay	true
character_trait_levels_colour_text_wh2_main_skill_innate_hef_prince_army_0_ill_prepared	This one would forget their head if it wasn't, er, attached.	true
character_trait_levels_onscreen_name_wh2_main_skill_innate_hef_prince_army_0_ill_prepared	Ill-Prepared	true
character_trait_levels_colour_text_wh2_main_skill_innate_hef_prince_army_0_scornful	"Strategy? Tactics? Piffle, more like. Charrrrgggge!!!"	true
character_trait_levels_onscreen_name_wh2_main_skill_innate_hef_prince_army_0_scornful	Scornful	true
character_trait_levels_colour_text_wh2_main_skill_innate_hef_prince_army_3_competent	This one understands tactics, and how to vary them, well enough to generally defeat the foe.	true
character_trait_levels_onscreen_name_wh2_main_skill_innate_hef_prince_army_3_competent	Competent	true
character_trait_levels_colour_text_wh2_main_skill_innate_hef_prince_army_3_respectful	"Our forefathers followed the way and overcame great adversity. We should not ignore their lessons."	true
character_trait_levels_onscreen_name_wh2_main_skill_innate_hef_prince_army_3_respectful	Respectful	true
character_trait_levels_colour_text_wh2_main_skill_innate_hef_prince_army_3_strong_willed	Some minds are more susceptible to magical influence than others, but this one is strong indeed.	true
character_trait_levels_onscreen_name_wh2_main_skill_innate_hef_prince_army_3_strong_willed	Strong-Willed	true
character_trait_levels_colour_text_wh2_main_skill_innate_hef_prince_army_7_doctrinal	"Right, are you listening? Good. There's only one way to do things and that's by the book."	true
character_trait_levels_onscreen_name_wh2_main_skill_innate_hef_prince_army_7_doctrinal	Doctrinal	true
character_trait_levels_colour_text_wh2_main_skill_innate_hef_prince_army_7_dragon_willed	Immovable and resolute in their will, this one is as determined as the World Dragon himself!	true
character_trait_levels_onscreen_name_wh2_main_skill_innate_hef_prince_army_7_dragon_willed	Dragon-Willed	true
character_trait_levels_colour_text_wh2_main_skill_innate_hef_prince_army_7_resistant	Action, inaction, change - you name it, this one will work against the prevailing wind.	true
character_trait_levels_onscreen_name_wh2_main_skill_innate_hef_prince_army_7_resistant	Resistant	true
character_trait_levels_colour_text_wh2_main_skill_innate_hef_prince_battle_0_pale_and_wan	It's as much effort as this one can make to lift a blade, let alone swing it at an opponent with force.	true
character_trait_levels_onscreen_name_wh2_main_skill_innate_hef_prince_battle_0_pale_and_wan	Pale & Wan	true
character_trait_levels_colour_text_wh2_main_skill_innate_hef_prince_battle_0_pigeon_chested	Bones are not supposed to be on the outside.	true
character_trait_levels_onscreen_name_wh2_main_skill_innate_hef_prince_battle_0_pigeon_chested	Pigeon-Chested	true
character_trait_levels_colour_text_wh2_main_skill_innate_hef_prince_battle_0_squishy	Some warriors are like rocks - hard and immovable. This one is like jelly…	true
character_trait_levels_onscreen_name_wh2_main_skill_innate_hef_prince_battle_0_squishy	Squishy	true
character_trait_levels_colour_text_wh2_main_skill_innate_hef_prince_battle_3_elusive	This one moves like lightning, ducking and twisting to avoid their opponent's blows.	true
character_trait_levels_onscreen_name_wh2_main_skill_innate_hef_prince_battle_3_elusive	Elusive	true
character_trait_levels_colour_text_wh2_main_skill_innate_hef_prince_battle_3_hale_and_hearty	The very picture of good health. Clearly, there's many years still ahead of them.	true
character_trait_levels_onscreen_name_wh2_main_skill_innate_hef_prince_battle_3_hale_and_hearty	Hale & Hearty	true
character_trait_levels_colour_text_wh2_main_skill_innate_hef_prince_battle_3_trained	Every action is executed seemingly without effort.	true
character_trait_levels_onscreen_name_wh2_main_skill_innate_hef_prince_battle_3_trained	Trained	true
character_trait_levels_colour_text_wh2_main_skill_innate_hef_prince_battle_7_dangerous	You really don't want to be on the receiving end of an attack made by this one. You really don’t.	true
character_trait_levels_onscreen_name_wh2_main_skill_innate_hef_prince_battle_7_dangerous	Dangerous	true
character_trait_levels_colour_text_wh2_main_skill_innate_hef_prince_battle_7_resilient	Armour is just a formality when you're as hard as nails and as tough as old boots.	true
character_trait_levels_onscreen_name_wh2_main_skill_innate_hef_prince_battle_7_resilient	Resilient	true
character_trait_levels_colour_text_wh2_main_skill_innate_hef_prince_battle_7_vigorous	This one is not at all easy to kill, and many have tried, believe me.	true
character_trait_levels_onscreen_name_wh2_main_skill_innate_hef_prince_battle_7_vigorous	Vigorous	true
character_trait_levels_colour_text_wh2_main_skill_innate_hef_prince_campaign_0_birdbrained	How this… absolute, card-carrying moron has survived this far is anyone's guess, and a mystery to all!	true
character_trait_levels_onscreen_name_wh2_main_skill_innate_hef_prince_campaign_0_birdbrained	Bird-Brained	true
character_trait_levels_colour_text_wh2_main_skill_innate_hef_prince_campaign_0_disorganised	If you want something done, shoot this one first - it'll make your life a lot easier.	true
character_trait_levels_onscreen_name_wh2_main_skill_innate_hef_prince_campaign_0_disorganised	Disorganised	true
character_trait_levels_colour_text_wh2_main_skill_innate_hef_prince_campaign_0_wasteful	"Yes, we will hit our own troops, but we'll hit theirs as well. We have reserves. Attack!"	true
character_trait_levels_onscreen_name_wh2_main_skill_innate_hef_prince_campaign_0_wasteful	Wasteful	true
character_trait_levels_colour_text_wh2_main_skill_innate_hef_prince_campaign_3_observant	If you wish to live, it's best to keep your eyes open and your head down.	true
character_trait_levels_onscreen_name_wh2_main_skill_innate_hef_prince_campaign_3_observant	Observant	true
character_trait_levels_colour_text_wh2_main_skill_innate_hef_prince_campaign_3_organised	"You need a plan. Never let anyone tell you otherwise. Devise a plan, then execute it - and preferably the enemy - haha!"	true
character_trait_levels_onscreen_name_wh2_main_skill_innate_hef_prince_campaign_3_organised	Organised	true
character_trait_levels_colour_text_wh2_main_skill_innate_hef_prince_campaign_3_unsentimental	Sentiments - and indeed feelings of any kind - are not for public display, in their estimation.	true
character_trait_levels_onscreen_name_wh2_main_skill_innate_hef_prince_campaign_3_unsentimental	Unsentimental	true
character_trait_levels_colour_text_wh2_main_skill_innate_hef_prince_campaign_7_adept	More than skilled, this one shows great proficiency in matters of war.	true
character_trait_levels_onscreen_name_wh2_main_skill_innate_hef_prince_campaign_7_adept	Adept	true
character_trait_levels_colour_text_wh2_main_skill_innate_hef_prince_campaign_7_avaricious	Their love of shiny things is so great this one could be an honorary Greenskin!	true
character_trait_levels_onscreen_name_wh2_main_skill_innate_hef_prince_campaign_7_avaricious	Avaricious	true
character_trait_levels_colour_text_wh2_main_skill_innate_hef_prince_campaign_7_efficient	Form, fire, charge, flank, repeat. This one shows that it really can be that simple.	true
character_trait_levels_onscreen_name_wh2_main_skill_innate_hef_prince_campaign_7_efficient	Efficient	true
character_trait_levels_colour_text_wh2_main_skill_innate_hef_princess_army_0_indolent	Someone less suited to bodily activity it would be hard to find.	true
character_trait_levels_onscreen_name_wh2_main_skill_innate_hef_princess_army_0_indolent	Indolent	true
character_trait_levels_colour_text_wh2_main_skill_innate_hef_princess_army_0_poltroon	When their army charges towards the foe, this one can clearly be seen legging it in the opposite direction!	true
character_trait_levels_onscreen_name_wh2_main_skill_innate_hef_princess_army_0_poltroon	Poltroon	true
character_trait_levels_colour_text_wh2_main_skill_innate_hef_princess_army_0_soft_hearted	Kindness and consideration are virtues. No, really, they are!	true
character_trait_levels_onscreen_name_wh2_main_skill_innate_hef_princess_army_0_soft_hearted	Soft-Hearted	true
character_trait_levels_colour_text_wh2_main_skill_innate_hef_princess_army_3_brisk	Why walk when you can run? Why run when you can fly?	true
character_trait_levels_onscreen_name_wh2_main_skill_innate_hef_princess_army_3_brisk	Brisk	true
character_trait_levels_colour_text_wh2_main_skill_innate_hef_princess_army_3_resolute	Unswerving and determined, this one is an immovable force on the battlefield.	true
character_trait_levels_onscreen_name_wh2_main_skill_innate_hef_princess_army_3_resolute	Resolute	true
character_trait_levels_colour_text_wh2_main_skill_innate_hef_princess_army_3_retaliatory	Revenge is not a dish best served cold; it is always perfectly sweet, no matter the temperature.	true
character_trait_levels_onscreen_name_wh2_main_skill_innate_hef_princess_army_3_retaliatory	Retaliatory	true
character_trait_levels_colour_text_wh2_main_skill_innate_hef_princess_army_7_dashing	You can almost see the hearts fluttering when this one passes by, on their way to derring-do and adventure.	true
character_trait_levels_onscreen_name_wh2_main_skill_innate_hef_princess_army_7_dashing	Dashing	true
character_trait_levels_colour_text_wh2_main_skill_innate_hef_princess_army_7_energetic	Always animated, this one has an infectious vitality about them.	true
character_trait_levels_onscreen_name_wh2_main_skill_innate_hef_princess_army_7_energetic	Energetic	true
character_trait_levels_colour_text_wh2_main_skill_innate_hef_princess_army_7_punitive	It's always someone's fault. They can always be made to pay.	true
character_trait_levels_onscreen_name_wh2_main_skill_innate_hef_princess_army_7_punitive	Punitive	true
character_trait_levels_colour_text_wh2_main_skill_innate_hef_princess_battle_0_feeble	It's surprising that this one can even lift a pen, let alone a sword.	true
character_trait_levels_onscreen_name_wh2_main_skill_innate_hef_princess_battle_0_feeble	Feeble	true
character_trait_levels_colour_text_wh2_main_skill_innate_hef_princess_battle_0_inaccurate	This one couldn't hit an Ogre at ten yards, let alone a ravening pack of Skaven!	true
character_trait_levels_onscreen_name_wh2_main_skill_innate_hef_princess_battle_0_inaccurate	Inaccurate	true
character_trait_levels_colour_text_wh2_main_skill_innate_hef_princess_battle_0_unfortunate	Locking themselves out of rooms; that bad batch of oysters; the one stray arrow - this one is more than simply unlucky!	true
character_trait_levels_onscreen_name_wh2_main_skill_innate_hef_princess_battle_0_unfortunate	Unfortunate	true
character_trait_levels_colour_text_wh2_main_skill_innate_hef_princess_battle_3_accurate	This one can hit an Ogre at one hundred yards, and a ravening pack of Skaven at fifty!	true
character_trait_levels_onscreen_name_wh2_main_skill_innate_hef_princess_battle_3_accurate	Accurate	true
character_trait_levels_colour_text_wh2_main_skill_innate_hef_princess_battle_3_fortuitous	Chance is like magic - it can be harnessed to the individual's will.	true
character_trait_levels_onscreen_name_wh2_main_skill_innate_hef_princess_battle_3_fortuitous	Fortuitous	true
character_trait_levels_colour_text_wh2_main_skill_innate_hef_princess_battle_3_well_founded	Always considered, never rushing to judge, all conclusions based on empirical evidence, no conjecture.	true
character_trait_levels_onscreen_name_wh2_main_skill_innate_hef_princess_battle_3_well_founded	Well-Founded	true
character_trait_levels_colour_text_wh2_main_skill_innate_hef_princess_battle_7_charmed	There must be runes about their person - no one could be this lucky otherwise!	true
character_trait_levels_onscreen_name_wh2_main_skill_innate_hef_princess_battle_7_charmed	Charmed	true
character_trait_levels_colour_text_wh2_main_skill_innate_hef_princess_battle_7_hawk_eyed	You have to get up very early if you want to beat this one; nothing escapes their keen eye and lightning reflexes.	true
character_trait_levels_onscreen_name_wh2_main_skill_innate_hef_princess_battle_7_hawk_eyed	Hawk-Eyed	true
character_trait_levels_colour_text_wh2_main_skill_innate_hef_princess_battle_7_strong	The strength at the base of the pillar.	true
character_trait_levels_onscreen_name_wh2_main_skill_innate_hef_princess_battle_7_strong	Strong	true
character_trait_levels_colour_text_wh2_main_skill_innate_hef_princess_campaign_0_dullard	There's dull, boring, and inattentive... and there's this live wire.	true
character_trait_levels_onscreen_name_wh2_main_skill_innate_hef_princess_campaign_0_dullard	Dullard	true
character_trait_levels_colour_text_wh2_main_skill_innate_hef_princess_campaign_0_slovenly	Everything is such an effort - they'd much rather feast than fight.	true
character_trait_levels_onscreen_name_wh2_main_skill_innate_hef_princess_campaign_0_slovenly	Slovenly	true
character_trait_levels_colour_text_wh2_main_skill_innate_hef_princess_campaign_0_tardy	This one would be late for their own funeral pyre if it were possible!	true
character_trait_levels_onscreen_name_wh2_main_skill_innate_hef_princess_campaign_0_tardy	Tardy	true
character_trait_levels_colour_text_wh2_main_skill_innate_hef_princess_campaign_3_careful	When this one plans an ambush, every possible option is considered. Nothing is left to chance.	true
character_trait_levels_onscreen_name_wh2_main_skill_innate_hef_princess_campaign_3_careful	Careful	true
character_trait_levels_colour_text_wh2_main_skill_innate_hef_princess_campaign_3_example	In battle, this one is a shining example for others to follow - and the foe to run away from!	true
character_trait_levels_onscreen_name_wh2_main_skill_innate_hef_princess_campaign_3_example	Example	true
character_trait_levels_colour_text_wh2_main_skill_innate_hef_princess_campaign_3_keen	Sitting around waiting for something to happen is not their style.	true
character_trait_levels_onscreen_name_wh2_main_skill_innate_hef_princess_campaign_3_keen	Keen	true
character_trait_levels_colour_text_wh2_main_skill_innate_hef_princess_campaign_7_ardent	More than keen, this one is positively champing at the bit to get up and at the enemy.	true
character_trait_levels_onscreen_name_wh2_main_skill_innate_hef_princess_campaign_7_ardent	Ardent	true
character_trait_levels_colour_text_wh2_main_skill_innate_hef_princess_campaign_7_exemplar	A paragon of martial excellence, with few peers among their own kind, let alone the enemy.	true
character_trait_levels_onscreen_name_wh2_main_skill_innate_hef_princess_campaign_7_exemplar	Exemplar	true
character_trait_levels_colour_text_wh2_main_skill_innate_hef_princess_campaign_7_vigilant	Ever watchful, this one bides their time until precisely the right moment to attack.	true
character_trait_levels_onscreen_name_wh2_main_skill_innate_hef_princess_campaign_7_vigilant	Vigilant	true
character_trait_levels_colour_text_wh2_main_skill_innate_hef_teclis_agent_1	As master of the foremost Asur mages, this Elf has studied in their secret libraries longer than most men live.	true
character_trait_levels_onscreen_name_wh2_main_skill_innate_hef_teclis_agent_1	Master of the Order	true
character_trait_levels_colour_text_wh2_main_skill_innate_hef_teclis_preeminent_mage	"This body may be frail, but never doubt the strength of the mind, or the heart within it."	true
character_trait_levels_onscreen_name_wh2_main_skill_innate_hef_teclis_preeminent_mage	Pre-Eminent Mage	true
character_trait_levels_colour_text_wh2_main_skill_innate_hef_tyrion_great_warrior	"Rally to my banner, and we shall bathe the plains with the blood of our enemies!"	true
character_trait_levels_onscreen_name_wh2_main_skill_innate_hef_tyrion_great_warrior	Great Warrior	true
character_trait_levels_colour_text_wh2_main_skill_innate_lzd_arrogant	Self-important and opinionated, this one's hubris knows no end.	true
character_trait_levels_onscreen_name_wh2_main_skill_innate_lzd_arrogant	Arrogant	true
character_trait_levels_colour_text_wh2_main_skill_innate_lzd_humble	Self-effacing and unpresuming, he believes that we all have a part to play in the Great Plan, one way or another.	true
character_trait_levels_onscreen_name_wh2_main_skill_innate_lzd_humble	Humble	true
character_trait_levels_colour_text_wh2_main_skill_innate_lzd_kroq_gar	As the last remaining warrior of the now ruined temple-city of Xhotl, for Kroq-Gar the battle is not yet over.	true
character_trait_levels_onscreen_name_wh2_main_skill_innate_lzd_kroq_gar	Last Defender	true
character_trait_levels_colour_text_wh2_main_skill_innate_lzd_mazdamundi_venerated	Oldest and most powerful of the living Mage-Priests, Mazdamundi is a figure of awe even amongst his own kind.	true
character_trait_levels_onscreen_name_wh2_main_skill_innate_lzd_mazdamundi_venerated	Venerated	true
character_trait_levels_colour_text_wh2_main_skill_innate_lzd_pompous	"What are you even for? You're not part of the Great Plan, like all your kind." 	true
character_trait_levels_onscreen_name_wh2_main_skill_innate_lzd_pompous	Pompous	true
character_trait_levels_colour_text_wh2_main_skill_innate_lzd_uncompromising	"The Plan is the Plan. We shall not deviate or retreat from its path."	true
character_trait_levels_onscreen_name_wh2_main_skill_innate_lzd_uncompromising	Uncompromising	true
character_trait_levels_colour_text_wh2_main_skill_innate_skv_queek_gnawdwells_right_claw	As Right-Claw to Warlord Gnawdwell, Queek Headtaker has risen high within Clan Mors – a credit to the terrible violence he’s unleashed along the way.	true
character_trait_levels_onscreen_name_wh2_main_skill_innate_skv_queek_gnawdwells_right_claw	Gnawdwell's Right-Claw	true
character_trait_levels_colour_text_wh2_main_skill_innate_skv_sharp_claws	"I keep them sharp, yes-yes. Always ready for the challenge that I know is coming, yes-yes!"	true
character_trait_levels_onscreen_name_wh2_main_skill_innate_skv_sharp_claws	Sharp Claws	true
character_trait_levels_colour_text_wh2_main_skill_innate_skv_sharp_teeth	"When they come for you, go straight for the throat and tear it clean out. They won't come again."	true
character_trait_levels_onscreen_name_wh2_main_skill_innate_skv_sharp_teeth	Sharp Teeth	true
character_trait_levels_colour_text_wh2_main_skill_innate_skv_skrolk_plaguelord	Rather than weakening with age, Lord Skrolk is possessed with a diabolic vitality that belies the years and the heaped diseases he carries.	true
character_trait_levels_onscreen_name_wh2_main_skill_innate_skv_skrolk_plaguelord	Plaguelord	true
character_trait_levels_colour_text_wh2_main_skill_innate_skv_sneaky	By their very nature, rats are very sneaky - even sneakier than Goblins. In fact, they're probably the sneakiest of all.	true
character_trait_levels_onscreen_name_wh2_main_skill_innate_skv_sneaky	Sneaky	true
character_trait_levels_colour_text_wh2_main_skill_innate_skv_warpstone_hoarder	"Most precious of all substances, the pulse of our life."	true
character_trait_levels_onscreen_name_wh2_main_skill_innate_skv_warpstone_hoarder	Warpstone Hoarder	true
character_trait_levels_colour_text_wh2_main_skill_innate_vmp_dark_majesty	"Glory in your dark majesty, my lord."	true
character_trait_levels_onscreen_name_wh2_main_skill_innate_vmp_dark_majesty	Dark Majesty	true
character_trait_levels_colour_text_wh2_main_skill_innate_vmp_devious	Vampires and their liche-servants are devious creatures; manipulative with many mortal servants in their thrall.	true
character_trait_levels_onscreen_name_wh2_main_skill_innate_vmp_devious	Devious 	true
character_trait_levels_colour_text_wh2_main_skill_innate_vmp_dread_incarnate	"They will tremble, my lord, oh, they will fear!"	true
character_trait_levels_onscreen_name_wh2_main_skill_innate_vmp_dread_incarnate	Dread Incarnate	true
character_trait_levels_colour_text_wh2_main_skill_innate_vmp_lore_keeper	Once forbidden knowledge is acquired, Necromancers and Vampires will jealously guard it from rivals' eyes.	true
character_trait_levels_onscreen_name_wh2_main_skill_innate_vmp_lore_keeper	Lore Keeper 	true
character_trait_levels_colour_text_wh2_main_skill_innate_vmp_master_of_the_black_arts	A master indeed - to rival the Great Necromancer himself?	true
character_trait_levels_onscreen_name_wh2_main_skill_innate_vmp_master_of_the_black_arts	Master of the Black Arts 	true
character_trait_levels_colour_text_wh2_main_skill_innate_wef_ariels_chosen	Those whom the Mage Queen has favoured fight as if powered by her hand.	true
character_trait_levels_onscreen_name_wh2_main_skill_innate_wef_ariels_chosen	Ariel's Chosen	true
character_trait_levels_colour_text_wh2_main_skill_innate_wef_talon_of_kurnous	The first arrow of battle must fly truest.	true
character_trait_levels_onscreen_name_wh2_main_skill_innate_wef_talon_of_kurnous	Talon of Kurnous	true
character_trait_levels_colour_text_wh_dlc03_skill_innate_bst_khazrak_the_one_eye	"With a roar, it pointed, and a pack of nightmare dog-beasts turned their feral attention towards me."	true
character_trait_levels_onscreen_name_wh_dlc03_skill_innate_bst_khazrak_the_one_eye	One-Eye	true
character_trait_levels_colour_text_wh_dlc03_skill_innate_bst_malagor	"Into the mud with them, break their skulls and eat their hearts!"	true
character_trait_levels_onscreen_name_wh_dlc03_skill_innate_bst_malagor	Crowfather	true
character_trait_levels_colour_text_wh_dlc03_skill_innate_bst_morghur_shadowgave	“Morghur returns. Morghur spread Gods’ corruption. Many die but all fall to Ruin. ALL!”	true
character_trait_levels_onscreen_name_wh_dlc03_skill_innate_bst_morghur_shadowgave	Shadowgave	true
character_trait_levels_colour_text_wh_dlc04_skill_innate_emp_volkmar_the_grim	"By the comet, that is my decree!"	true
character_trait_levels_onscreen_name_wh_dlc04_skill_innate_emp_volkmar_the_grim	Grand Theogonist	true
character_trait_levels_colour_text_wh_dlc04_skill_innate_vmp_helman_ghorst	The student thrives on heretical knowledge; dark foundations lead to darker, binding deliverance.	true
character_trait_levels_onscreen_name_wh_dlc04_skill_innate_vmp_helman_ghorst	Neophyte	true
character_trait_levels_colour_text_wh_dlc04_skill_innate_vmp_vlad_von_carstein	"Surrender and serve me in life, or die and slave for me in death."	true
character_trait_levels_onscreen_name_wh_dlc04_skill_innate_vmp_vlad_von_carstein	Consuming Thirst 	true
character_trait_levels_colour_text_wh_dlc05_skill_innate_wef_ariels_chosen	Those whom the Mage Queen has favoured fight as if powered by her hand.	true
character_trait_levels_onscreen_name_wh_dlc05_skill_innate_wef_ariels_chosen	Ariel's Chosen	true
character_trait_levels_colour_text_wh_dlc05_skill_innate_wef_durthu	“The forest does not forgive; the forest does not forget. You will all feed its roots in the end, one way or another…”	true
character_trait_levels_onscreen_name_wh_dlc05_skill_innate_wef_durthu	Eldest of Ancients	true
character_trait_levels_colour_text_wh_dlc05_skill_innate_wef_orion	“Do you understand? You are more than you were – more than just flesh and bone; you are everything that defines us."	true
character_trait_levels_onscreen_name_wh_dlc05_skill_innate_wef_orion	King in the Woods	true
character_trait_levels_colour_text_wh_dlc05_skill_innate_wef_talon_of_kurnous	The first arrow of battle must fly truest.	true
character_trait_levels_onscreen_name_wh_dlc05_skill_innate_wef_talon_of_kurnous	Talon of Kurnous	true
character_trait_levels_colour_text_wh_dlc06_skill_innate_dwf_belegar	“The Throne of the Eight Peaks is mine, by right!”	true
character_trait_levels_onscreen_name_wh_dlc06_skill_innate_dwf_belegar	True King of the Eight Peaks	true
character_trait_levels_colour_text_wh_dlc06_skill_innate_grn_skarsnik	“The Peaks belong to me. I dare yoo to try and take ‘em from me, stunty.”	true
character_trait_levels_onscreen_name_wh_dlc06_skill_innate_grn_skarsnik	Warlord of Karak Eight Peaks	true
character_trait_levels_colour_text_wh_dlc06_skill_innate_grn_wurrzag	“Da Godz speak ta me. Listen, and I’ll tell ya.”	true
character_trait_levels_onscreen_name_wh_dlc06_skill_innate_grn_wurrzag	Da Great Green Prophet	true
character_trait_levels_colour_text_wh_dlc06_skill_node_dwf_ghost_1_champion_innate_dummy	[HIDDEN] Skill to lower the line	true
character_trait_levels_onscreen_name_wh_dlc06_skill_node_dwf_ghost_1_champion_innate_dummy	[HIDDEN] Skill to lower the line	true
character_trait_levels_colour_text_wh_dlc07_brt_skill_innate_all_honourable	Honour is everything!	true
character_trait_levels_onscreen_name_wh_dlc07_brt_skill_innate_all_honourable	Honourable	true
character_trait_levels_colour_text_wh_dlc07_brt_skill_innate_all_intelligent	In this age of blood and battle, intellect is an underrated gift.	true
character_trait_levels_onscreen_name_wh_dlc07_brt_skill_innate_all_intelligent	Intelligent	true
character_trait_levels_colour_text_wh_dlc07_brt_skill_innate_all_magnanimous	"This victory is not mine alone, we all share in the glory."	true
character_trait_levels_onscreen_name_wh_dlc07_brt_skill_innate_all_magnanimous	Magnanimous	true
character_trait_levels_colour_text_wh_dlc07_brt_skill_innate_all_melancholic	"Why forlorn? Are you not a king, an emperor - a champion?"	true
character_trait_levels_onscreen_name_wh_dlc07_brt_skill_innate_all_melancholic	Melancholic	true
character_trait_levels_colour_text_wh_dlc07_brt_skill_innate_all_phlegmatic	A calming presence can be a steadying hand… but also disquieting.	true
character_trait_levels_onscreen_name_wh_dlc07_brt_skill_innate_all_phlegmatic	Phlegmatic	true
character_trait_levels_colour_text_wh_dlc07_brt_skill_innate_all_sanguine	An assured air instils great confidence in your followers.	true
character_trait_levels_onscreen_name_wh_dlc07_brt_skill_innate_all_sanguine	Sanguine	true
character_trait_levels_colour_text_wh_dlc07_brt_skill_innate_all_uncompromising	Others may call it decisive, but being uncompromising can be a weakness as well as a strength.	true
character_trait_levels_onscreen_name_wh_dlc07_brt_skill_innate_all_uncompromising	Uncompromising	true
character_trait_levels_colour_text_wh_dlc07_skill_brt_innate_fay_enchantress	A figure of awe and inspiration, hers is the will of the goddess.	true
character_trait_levels_onscreen_name_wh_dlc07_skill_brt_innate_fay_enchantress	Supreme Aura of the Lady	true
character_trait_levels_colour_text_wh_dlc08_skill_innate_nor_throgg	Atypical of his savage, stupid kind, Throgg is possessed of a grim, malevolent cunning that raises him far above his peers.	true
character_trait_levels_onscreen_name_wh_dlc08_skill_innate_nor_throgg	Monstrous Ruler	true
character_trait_levels_colour_text_wh_dlc08_skill_innate_nor_wulfrik	Born to slaughter in their Ruinous names, Wulfrik bears the Mark of the Dark Gods upon his flesh.	true
character_trait_levels_onscreen_name_wh_dlc08_skill_innate_nor_wulfrik	Born Warrior	true
character_trait_levels_colour_text_wh_main_skill_innate_all_arrogant	It's not just the Elves that suffer from this affliction then?	true
character_trait_levels_onscreen_name_wh_main_skill_innate_all_arrogant	Arrogant	true
character_trait_levels_colour_text_wh_main_skill_innate_all_blind	Although the eyes do not see, the other senses remain open.	true
character_trait_levels_onscreen_name_wh_main_skill_innate_all_blind	Blind	true
character_trait_levels_colour_text_wh_main_skill_innate_all_blood_feud	Only the blood of the wretch will settle this.	true
character_trait_levels_onscreen_name_wh_main_skill_innate_all_blood_feud	Blood Feud	true
character_trait_levels_colour_text_wh_main_skill_innate_all_boring	"Another speech? Very well… does it have to be so… lengthy?"	true
character_trait_levels_onscreen_name_wh_main_skill_innate_all_boring	Boring	true
character_trait_levels_colour_text_wh_main_skill_innate_all_charismatic	"We stand together! I promise I will not leave your side, brothers! Will you join me?"	true
character_trait_levels_onscreen_name_wh_main_skill_innate_all_charismatic	Charismatic	true
character_trait_levels_colour_text_wh_main_skill_innate_all_choleric	Does a rage as hot as Khorne's burn within?	true
character_trait_levels_onscreen_name_wh_main_skill_innate_all_choleric	Choleric	true
character_trait_levels_colour_text_wh_main_skill_innate_all_clumsy	There are drunk Ogres more sure-footed than this one.	true
character_trait_levels_onscreen_name_wh_main_skill_innate_all_clumsy	Clumsy	true
character_trait_levels_colour_text_wh_main_skill_innate_all_deformed	Deformed by birth or made by the Ruinous Powers, yet there is honour within the prison of flesh.	true
character_trait_levels_onscreen_name_wh_main_skill_innate_all_deformed	Misshapen	true
character_trait_levels_colour_text_wh_main_skill_innate_all_easily_deceived	"Tzeentch will have so much fun with you, puppet!"	true
character_trait_levels_onscreen_name_wh_main_skill_innate_all_easily_deceived	Easily Deceived	true
character_trait_levels_colour_text_wh_main_skill_innate_all_easily_distracted	"Look! Over there - a Snotling showing its arse!"	true
character_trait_levels_onscreen_name_wh_main_skill_innate_all_easily_distracted	Easily Distracted	true
character_trait_levels_colour_text_wh_main_skill_innate_all_easily_trapped	To trap a fool is easy; to trap a King… perhaps even easier.	true
character_trait_levels_onscreen_name_wh_main_skill_innate_all_easily_trapped	Easily Trapped	true
character_trait_levels_colour_text_wh_main_skill_innate_all_handsome	Such chiselled good looks belie a confidence that a homely face cannot parse.	true
character_trait_levels_onscreen_name_wh_main_skill_innate_all_handsome	Handsome	true
character_trait_levels_colour_text_wh_main_skill_innate_all_honourable	Honour is everything!	true
character_trait_levels_onscreen_name_wh_main_skill_innate_all_honourable	Honourable	true
character_trait_levels_colour_text_wh_main_skill_innate_all_humble	A humble creature, shamed by praise and thoughtful in their dealings.	true
character_trait_levels_onscreen_name_wh_main_skill_innate_all_humble	Humble	true
character_trait_levels_colour_text_wh_main_skill_innate_all_intelligent	In this age of blood and battle, intellect is an underrated gift.	true
character_trait_levels_onscreen_name_wh_main_skill_innate_all_intelligent	Intelligent	true
character_trait_levels_colour_text_wh_main_skill_innate_all_irresolute	"To be crippled by indecision is to give your enemies an advantage."	true
character_trait_levels_onscreen_name_wh_main_skill_innate_all_irresolute	Irresolute	true
character_trait_levels_colour_text_wh_main_skill_innate_all_magnanimous	"This victory is not mine alone, we all share in the glory."	true
character_trait_levels_onscreen_name_wh_main_skill_innate_all_magnanimous	Magnanimous	true
character_trait_levels_colour_text_wh_main_skill_innate_all_maimed_arm	"This one is armless, sir."	true
character_trait_levels_onscreen_name_wh_main_skill_innate_all_maimed_arm	Maimed Arm	true
character_trait_levels_colour_text_wh_main_skill_innate_all_maimed_leg	"No, not drunk, just legless."	true
character_trait_levels_onscreen_name_wh_main_skill_innate_all_maimed_leg	Maimed Leg	true
character_trait_levels_colour_text_wh_main_skill_innate_all_melancholic	"Why forlorn? Are you not a King, an Emperor - a champion?"	true
character_trait_levels_onscreen_name_wh_main_skill_innate_all_melancholic	Melancholic	true
character_trait_levels_colour_text_wh_main_skill_innate_all_military_heritage	Born in battle, dragged up in war.	true
character_trait_levels_onscreen_name_wh_main_skill_innate_all_military_heritage	Military Heritage	true
character_trait_levels_colour_text_wh_main_skill_innate_all_phlegmatic	A calming presence can be a steadying hand… but also disquieting.	true
character_trait_levels_onscreen_name_wh_main_skill_innate_all_phlegmatic	Phlegmatic	true
character_trait_levels_colour_text_wh_main_skill_innate_all_sanguine	An assured air instils great confidence in your followers.	true
character_trait_levels_onscreen_name_wh_main_skill_innate_all_sanguine	Sanguine	true
character_trait_levels_colour_text_wh_main_skill_innate_all_scar_disfiguring	Such an ugly scar is always memorable.	true
character_trait_levels_onscreen_name_wh_main_skill_innate_all_scar_disfiguring	Disfiguring Scar	true
character_trait_levels_colour_text_wh_main_skill_innate_all_scar_distinguishing	Clearly a veteran of some heroic deed.	true
character_trait_levels_onscreen_name_wh_main_skill_innate_all_scar_distinguishing	Distinguishing Scar	true
character_trait_levels_colour_text_wh_main_skill_innate_all_sneaky	Skulk and sneak or shadow and stalk, theirs is a guileful nature.	true
character_trait_levels_onscreen_name_wh_main_skill_innate_all_sneaky	Sneaky	true
character_trait_levels_colour_text_wh_main_skill_innate_all_spurned	Spurned by his allies, this man will struggle to regain favour.	true
character_trait_levels_onscreen_name_wh_main_skill_innate_all_spurned	Spurned	true
character_trait_levels_colour_text_wh_main_skill_innate_all_stupid	Shares the intellect of a River Troll.	true
character_trait_levels_onscreen_name_wh_main_skill_innate_all_stupid	Stupid	true
character_trait_levels_colour_text_wh_main_skill_innate_all_ugly	One of the Plague Father's creations perhaps?	true
character_trait_levels_onscreen_name_wh_main_skill_innate_all_ugly	Ugly	true
character_trait_levels_colour_text_wh_main_skill_innate_all_uncompromising	Others may call it decisive, but being uncompromising can be a weakness as well as a strength.	true
character_trait_levels_onscreen_name_wh_main_skill_innate_all_uncompromising	Uncompromising	true
character_trait_levels_colour_text_wh_main_skill_innate_brt_louen_leoncouer	Chaste, honourable, and untainted by notions of self-aggrandisement, King Louen is the most virtuous of all the Lady's champions.	true
character_trait_levels_onscreen_name_wh_main_skill_innate_brt_louen_leoncouer	The Puissant Virtue	true
character_trait_levels_colour_text_wh_main_skill_innate_brt_virtue_audacity	A master of the feint and riposte, this Knight's skill at turning an enemy's strength against them is legendary.	true
character_trait_levels_onscreen_name_wh_main_skill_innate_brt_virtue_audacity	Virtue of Audacity	true
character_trait_levels_colour_text_wh_main_skill_innate_brt_virtue_confidence	Haughty, proud, and skilful, this Knight never takes a backward step in the face of adversity.	true
character_trait_levels_onscreen_name_wh_main_skill_innate_brt_virtue_confidence	Virtue of Confidence	true
character_trait_levels_colour_text_wh_main_skill_innate_brt_virtue_discipline	No matter the odds, this Knight takes to the field utterly undaunted by the numberless hordes of his enemies.	true
character_trait_levels_onscreen_name_wh_main_skill_innate_brt_virtue_discipline	Virtue of Discipline	true
character_trait_levels_colour_text_wh_main_skill_innate_brt_virtue_duty	Most loyal of Companions, this Knight fights always at the side of his Liege.	true
character_trait_levels_onscreen_name_wh_main_skill_innate_brt_virtue_duty	Virtue of Duty	true
character_trait_levels_colour_text_wh_main_skill_innate_brt_virtue_heroism	Unbending even in the face of the greatest beasts, this Knight mounts their heads on the wall of his feasting chamber.	true
character_trait_levels_onscreen_name_wh_main_skill_innate_brt_virtue_heroism	Virtue of Heroism	true
character_trait_levels_colour_text_wh_main_skill_innate_brt_virtue_ideal	This Knight's skill, prowess, and finesse with blade and lance are beyond compare; his bravery, horsemanship, and chivalry above all others.	true
character_trait_levels_onscreen_name_wh_main_skill_innate_brt_virtue_ideal	Virtue of the Ideal	true
character_trait_levels_colour_text_wh_main_skill_innate_brt_virtue_impetuous_knight	In the glory of the charge is this Knight most alive, ever in the forefront of battle.	true
character_trait_levels_onscreen_name_wh_main_skill_innate_brt_virtue_impetuous_knight	Virtue of the Impetuous Knight	true
character_trait_levels_colour_text_wh_main_skill_innate_brt_virtue_joust	So great is this Knight's skill with a lance that none can unhorse them.	true
character_trait_levels_onscreen_name_wh_main_skill_innate_brt_virtue_joust	Virtue of the Joust	true
character_trait_levels_colour_text_wh_main_skill_innate_brt_virtue_knightly_temper	With a heart of stone and resolute temper this Knight stands unbowed, spilling the foe's blood with each sweep and thrust.	true
character_trait_levels_onscreen_name_wh_main_skill_innate_brt_virtue_knightly_temper	Virtue of Knightly Temper	true
character_trait_levels_colour_text_wh_main_skill_innate_brt_virtue_noble_disdain	This Knight has great contempt for those who eschew the martial values of meeting one's opponent face to face.	true
character_trait_levels_onscreen_name_wh_main_skill_innate_brt_virtue_noble_disdain	Virtue of Noble Disdain	true
character_trait_levels_colour_text_wh_main_skill_innate_brt_virtue_penitent	A hermit-Knight, this one nevertheless always returns to fight for his beloved king.	true
character_trait_levels_onscreen_name_wh_main_skill_innate_brt_virtue_penitent	Virtue of Penitent	true
character_trait_levels_colour_text_wh_main_skill_innate_brt_virtue_stoicism	Steeled by this Knight's bravery, those around them fight with the courage of the Breton himself.	true
character_trait_levels_onscreen_name_wh_main_skill_innate_brt_virtue_stoicism	Virtue of Stoicism	true
character_trait_levels_colour_text_wh_main_skill_innate_chs_archaon_the_everchosen	"I will be the axis upon which the wheel of change turns, and the world will drown in the light of unborn stars."	true
character_trait_levels_onscreen_name_wh_main_skill_innate_chs_archaon_the_everchosen	Vessel	true
character_trait_levels_colour_text_wh_main_skill_innate_chs_diabolic_spendour	Oh, horrific wonder! Vile awe! Such hateful majesty!	true
character_trait_levels_onscreen_name_wh_main_skill_innate_chs_diabolic_spendour	Diabolic Splendour 	true
character_trait_levels_colour_text_wh_main_skill_innate_chs_dominance	"Mine desire is all, mortal wretch!"	true
character_trait_levels_onscreen_name_wh_main_skill_innate_chs_dominance	Infernal Dominance 	true
character_trait_levels_colour_text_wh_main_skill_innate_chs_kholek_suneater	"The whole world will burn before I rest again."	true
character_trait_levels_onscreen_name_wh_main_skill_innate_chs_kholek_suneater	Mountain God	true
character_trait_levels_colour_text_wh_main_skill_innate_chs_prince_sigvald_the_magnificent	"Surely such sedition should sour and succumb to Sigvald!"	true
character_trait_levels_onscreen_name_wh_main_skill_innate_chs_prince_sigvald_the_magnificent	Supreme Vanity	true
character_trait_levels_colour_text_wh_main_skill_innate_dwf_ancestral_blood_grimnir	This brave Dawi can trace his lineage back to Grimnir, the Warrior God.	true
character_trait_levels_onscreen_name_wh_main_skill_innate_dwf_ancestral_blood_grimnir	Ancestral Blood - Grimnir	true
character_trait_levels_colour_text_wh_main_skill_innate_dwf_ancestral_blood_grungni	This industrious Dawi can trace his lineage back to Grungni, God of Mines and Smiths.	true
character_trait_levels_onscreen_name_wh_main_skill_innate_dwf_ancestral_blood_grungni	Ancestral Blood - Grungni	true
character_trait_levels_colour_text_wh_main_skill_innate_dwf_ancestral_blood_valaya	This loyal Dawi can trace his lineage back to Valaya, Goddess of Healing and Protection.	true
character_trait_levels_onscreen_name_wh_main_skill_innate_dwf_ancestral_blood_valaya	Ancestral Blood - Valaya	true
character_trait_levels_colour_text_wh_main_skill_innate_dwf_axe_envy	A Dwarf's az is his pride and joy - but what if a Dawi from a rival Clan has a more storied weapon?	true
character_trait_levels_onscreen_name_wh_main_skill_innate_dwf_axe_envy	Az Envy	true
character_trait_levels_colour_text_wh_main_skill_innate_dwf_thorgrim_grudgebearer	"This is my edict as High King! Khazukan Kazakit-ha!"	true
character_trait_levels_onscreen_name_wh_main_skill_innate_dwf_thorgrim_grudgebearer	High King	true
character_trait_levels_colour_text_wh_main_skill_innate_dwf_ungrim_ironfist	"Bring me victory, bring me death!"	true
character_trait_levels_onscreen_name_wh_main_skill_innate_dwf_ungrim_ironfist	Slayer King	true
character_trait_levels_colour_text_wh_main_skill_innate_emp_balthasar_gelt	"The Wind of Chamon will rise and blast any who get in my way!"	true
character_trait_levels_onscreen_name_wh_main_skill_innate_emp_balthasar_gelt	Transmuter	true
character_trait_levels_colour_text_wh_main_skill_innate_emp_karl_franz	"Our names will be remembered in our people's songs until the end of time!"	true
character_trait_levels_onscreen_name_wh_main_skill_innate_emp_karl_franz	Emperor	true
character_trait_levels_colour_text_wh_main_skill_innate_grn_azhag_the_slaughterer	"Wyverns is good fer one thing, eatin', smashin', smellin' and flyin'."	true
character_trait_levels_onscreen_name_wh_main_skill_innate_grn_azhag_the_slaughterer	Slaughterer	true
character_trait_levels_colour_text_wh_main_skill_innate_grn_choppa_envy	"Dere choppa's bigga dan mine."	true
character_trait_levels_onscreen_name_wh_main_skill_innate_grn_choppa_envy	Choppa Envy	true
character_trait_levels_colour_text_wh_main_skill_innate_grn_grimgor_ironhide	"Everyfing I see is mine."	true
character_trait_levels_onscreen_name_wh_main_skill_innate_grn_grimgor_ironhide	Warlord	true
character_trait_levels_colour_text_wh_main_skill_innate_grn_stabba_envy	"Dat stabba is longa dan mine!"	true
character_trait_levels_onscreen_name_wh_main_skill_innate_grn_stabba_envy	Stabba Envy	true
character_trait_levels_colour_text_wh_main_skill_innate_vmp_dark_acolyte	Some Vampires have an affinity for Necromantic magic beyond their peers.	true
character_trait_levels_onscreen_name_wh_main_skill_innate_vmp_dark_acolyte	Dark Acolyte	true
character_trait_levels_colour_text_wh_main_skill_innate_vmp_ghoul_whisperer	"They flock to you - the ghoul-kind. Direct them as you will."	true
character_trait_levels_onscreen_name_wh_main_skill_innate_vmp_ghoul_whisperer	Ghoul Whisperer 	true
character_trait_levels_colour_text_wh_main_skill_innate_vmp_heinrich_kemmler	"You and your masters are desiccated relics of a dead age."	true
character_trait_levels_onscreen_name_wh_main_skill_innate_vmp_heinrich_kemmler	Wanderer	true
character_trait_levels_colour_text_wh_main_skill_innate_vmp_mannfred_von_carstein	"My people will feast on your bones."	true
character_trait_levels_onscreen_name_wh_main_skill_innate_vmp_mannfred_von_carstein	Count	true
character_trait_levels_colour_text_wh_main_skill_innate_vmp_summon_creatures	Only the direst of all Undead creatures will come to this summons.	true
character_trait_levels_onscreen_name_wh_main_skill_innate_vmp_summon_creatures	Summon Creatures of the Night 	true
character_trait_levels_colour_text_wh_pro01_skill_innate_dwf_grombrindal	"You and your followers will die - that is my oath as my kin, Grimnir, is witness!"	true
character_trait_levels_onscreen_name_wh_pro01_skill_innate_dwf_grombrindal	White Dwarf	true
character_trait_levels_colour_text_wh_pro02_skill_innate_vmp_isabella	The Undead whole is always stronger than the sum of its parts.	true
character_trait_levels_onscreen_name_wh_pro02_skill_innate_vmp_isabella	Dark Retinue	true
