Loc PackedFile
Key	Text	Tooltip
campaign_map_tooltip_texts_tooltip_text_rome2_tltip_left_clk_inspect_must_break_siege	Left-click to select
Must break siege first	true
campaign_map_tooltip_texts_tooltip_text_wh2_main_tltip_player_force	Your force	true
campaign_map_tooltip_texts_tooltip_text_rome2_tltip_warning_no_access	[[img:ui/skins/default/icon_diplomacy_path.png]][[/img]][[col:red]]Trespassing will have diplomatic repercussions![[/col]]	true
campaign_map_tooltip_texts_tooltip_text_rome2_tltip_main_allied_general_on_sea	Allied transport ships	true
campaign_map_tooltip_texts_tooltip_text_rome2_tltip_warning_settlement_under_blockade	[[col:yellow]]This settlement is under blockade[[/col]]	true
campaign_map_tooltip_texts_tooltip_text_rome2_tltip_player_trade_route_self	Your trade route	true
campaign_map_tooltip_texts_tooltip_text_rome2_tltip_left_clk_select_must_break_siege	Left-click to select
Must break siege first	true
campaign_map_tooltip_texts_tooltip_text_rome2_tltip_hostile_sea_region_self	No replenishment or recruitment available.	true
campaign_map_tooltip_texts_tooltip_text_rome2_tltip_left_clk_inspect_right_clk_move_to_coast	Left-click to inspect
Right-click to move to the closest landing site	true
campaign_map_tooltip_texts_tooltip_text_rome2_tltip_warning_diplomatic_impact_attack	[[col:yellow]]Attacking foreign assets is an act of war![[/col]]	true
campaign_map_tooltip_texts_tooltip_text_rome2_tltip_must_break_siege	Must break siege first.	true
campaign_map_tooltip_texts_tooltip_text_rome2_tltip_main_non_player_admiral	Neutral fleet	true
campaign_map_tooltip_texts_tooltip_text_rome2_tltip_main_non_player_general	Neutral army	true
campaign_map_tooltip_texts_tooltip_text_wh2_main_tltip_player_blark	Your Black Ark	true
campaign_map_tooltip_texts_tooltip_text_rome2_tltip_main_allied_agent	Allied %S Hero	true
campaign_map_tooltip_texts_tooltip_text_rome2_tltip_main_player_general_on_sea	Your transport ships	true
campaign_map_tooltip_texts_tooltip_text_wh2_main_tltip_enemy_blark	Enemy Black Ark	true
campaign_map_tooltip_texts_tooltip_text_wh2_main_tltip_allied_blark	Allied Black Ark	true
campaign_map_tooltip_texts_tooltip_text_rome2_tltip_main_enemy_general	Enemy army	true
campaign_map_tooltip_texts_tooltip_text_rome2_tltip_main_enemy_admiral	Enemy fleet	true
campaign_map_tooltip_texts_tooltip_text_rome2_tltip_main_player_agent	Your %S Hero	true
campaign_map_tooltip_texts_tooltip_text_rome2_tltip_left_clk_select	Left-click to select	true
campaign_map_tooltip_texts_tooltip_text_rome2_tltip_right_clk_garrison_port_left_clk_select	Right-click to garrison the port
Left-click to select	true
campaign_map_tooltip_texts_tooltip_text_rome2_tltip_warning_diplomatic_impact_action	[[col:yellow]]Action against foreign assets may have diplomatic repercussions![[/col]]	true
campaign_map_tooltip_texts_tooltip_text_rome2_tltip_main_enemy_agent	Enemy %S Hero	true
campaign_map_tooltip_texts_tooltip_text_rome2_tltip_left_clk_inspect_right_declare_war	Right-click to declare war
Left-click to inspect	true
campaign_map_tooltip_texts_tooltip_text_rome2_tltip_warning_already_besieged	This settlement is already besieged.	true
campaign_map_tooltip_texts_tooltip_text_rome2_tltip_right_clk_attack_navy_left_clk_select_inspection	{{tr:rome2_tltip_right_clk_attack_army_left_clk_select_inspection}}	true
campaign_map_tooltip_texts_tooltip_text_rome2_tltip_warning_already_blockaded	This settlement is already blockaded.	true
campaign_map_tooltip_texts_tooltip_text_rome2_tltip_left_clk_select_inspection	Left-click to inspect	true
campaign_map_tooltip_texts_tooltip_text_rome2_tltip_warning_agent_cannot_act_own_settlement	Agents cannot act against their own settlements.	true
campaign_map_tooltip_texts_tooltip_text_rome2_tltip_warning_cannot_move_stance	[[col:red]]This army cannot move in its current stance.[[/col]]	true
campaign_map_tooltip_texts_tooltip_text_rome2_tltip_main_non_player_minor_settlement	Neutral minor settlement	true
campaign_map_tooltip_texts_tooltip_text_rome2_tltip_right_clk_act_against_character_left_clk_select_inspection	Right-click to act
Left-click to inspect	true
campaign_map_tooltip_texts_tooltip_text_rome2_tltip_main_enemy_general_on_sea	Enemy transport ships	true
campaign_map_tooltip_texts_tooltip_text_rome2_tltip_contested_sea_region_self	Replenishment or recruitment only happens at your ports.	true
campaign_map_tooltip_texts_tooltip_text_rome2_tltip_right_clk_attack_army_left_clk_select_inspection	{{tr:rome2_tltip_right_clk_attack_army_left_clk_select_inspection}}	true
campaign_map_tooltip_texts_tooltip_text_rome2_tltip_warning_already_besieged_non_enemy	This settlement is already besieged.
[[col:yellow]]Attacking foreign assets is an act of war![[/col]]	true
campaign_map_tooltip_texts_tooltip_text_rome2_tltip_left_clk_select_right_clk_move_to_coast	Left-click to select
Right-click to move to the closest landing site	true
campaign_map_tooltip_texts_tooltip_text_rome2_tltip_right_clk_embark	Right-click to embark	true
campaign_map_tooltip_texts_tooltip_text_rome2_tltip_main_non_player_province_capital	Neutral province capital	true
campaign_map_tooltip_texts_tooltip_text_rome2_tltip_main_player_minor_settlement	Your minor settlement	true
campaign_map_tooltip_texts_tooltip_text_rome_2_tltip_left_clk_select_right_clk_disembark_at_coast	Left-click to select
Right-click to disembark	true
campaign_map_tooltip_texts_tooltip_text_wh_main_tltip_waaagh_army_info	Host army: %s	true
campaign_map_tooltip_texts_tooltip_text_rome2_tltip_right_clk_transfer_units_left_clk_select_army	Right-click to exchange units
Left-click to select	true
campaign_map_tooltip_texts_tooltip_text_rome2_tltip_main_allied_province_capital	Allied province capital	true
campaign_map_tooltip_texts_tooltip_text_wh2_main_tltip_move_exit_stance	[[col:yellow]]Moving will exit this army's current stance.[[/col]]	true
campaign_map_tooltip_texts_tooltip_text_wh2_main_tltip_ruins	This settlement can be colonised or searched for treasure.	true
campaign_map_tooltip_texts_tooltip_text_rome2_tltip_main_province	Province: %S	true
campaign_map_tooltip_texts_tooltip_text_rome2_tltip_main_non_player_general_on_sea	Neutral transport ships	true
campaign_map_tooltip_texts_tooltip_text_rome2_tltip_right_clk_get_escorted_left_clk_select	Right-click to embed [[img:icon_hero]][[/img]]Hero
Left-click to select	true
campaign_map_tooltip_texts_tooltip_text_rome2_tltip_left_clk_select_warning_port_occupied	Left-click to select
The port is already occupied	true
campaign_map_tooltip_texts_tooltip_text_wh_main_tltip_waaagh_army	{{tr:your_waaagh_army_tooltip}}	true
campaign_map_tooltip_texts_tooltip_text_rome2_tltip_right_clk_act_against_army_left_clk_select_inspection	Right-click to act
Left-click to inspect	true
campaign_map_tooltip_texts_tooltip_text_rome2_tltip_abandoned_minor_region	Ruined minor settlement	true
campaign_map_tooltip_texts_tooltip_text_rome2_tltip_right_clk_attack_port_settlement_left_clk_select_inspection	Right-click to attack the port
Left-click to inspect	true
campaign_map_tooltip_texts_tooltip_text_rome_2_tltip_left_ck_inspect_right_clk_disembark_at_coast	Left-click to inspect
Right-click to disembark and attack	true
campaign_map_tooltip_texts_tooltip_text_rome2_tltip_main_player_province_capital	Your province capital	true
campaign_map_tooltip_texts_tooltip_text_rome2_tltip_right_clk_garrison_settlement_left_clk_select	Right-click to garrison the settlement
Left-click to select

Garrisoning a settlement will provide a bonus to [[img:icon_public_order]]{{tr:hp_campaign_public_order_term}}, though this will lessen based on the number of settlements controlled within the province.	true
campaign_map_tooltip_texts_tooltip_text_rome2_tltip_abandoned_major_region	Ruined province capital	true
campaign_map_tooltip_texts_tooltip_text_rome2_tltip_main_allied_minor_settlement	Allied minor settlement	true
campaign_map_tooltip_texts_tooltip_text_rome2_tltip_right_clk_move	Right-click to move	true
campaign_map_tooltip_texts_tooltip_text_wh2_main_tltip_attack_exit_stance	[[col:yellow]]Attacking will exit this army's current stance.[[/col]]	true
campaign_map_tooltip_texts_tooltip_text_rome2_tltip_left_clk_inscpect_must_break_blockade	Left-click to inspect
Must break blockade first	true
campaign_map_tooltip_texts_tooltip_text_rome2_tltip_right_clk_transfer_units_left_clk_select_navy	Right-click to exchange units
Left-click to select	true
campaign_map_tooltip_texts_tooltip_text_rome2_tltip_warning_port_occupied	The port is already occupied.	true
campaign_map_tooltip_texts_tooltip_text_rome2_tltip_player_sea_trade_route_self	Your naval trade route	true
campaign_map_tooltip_texts_tooltip_text_rome2_tltip_warning_already_blockaded_non_enemy	This settlement is already blockaded.
[[col:yellow]]Attacking foreign assets is an act of war![[/col]]	true
campaign_map_tooltip_texts_tooltip_text_rome2_tltip_right_clk_embed_agent_left_clk_select	Right-click to embed [[img:icon_hero]][[/img]]Hero
Left-click to select	true
campaign_map_tooltip_texts_tooltip_text_rome2_tltip_main_allied_general	Allied army	true
campaign_map_tooltip_texts_tooltip_text_rome2_tltip_left_clk_select_must_break_blockade	Left-click to select
Must break blockade first	true
campaign_map_tooltip_texts_tooltip_text_rome2_tltip_move_to_coast	Right-click to move to the closest landing site	true
campaign_map_tooltip_texts_tooltip_text_rome2_tltip_main_allied_admiral	Allied fleet	true
campaign_map_tooltip_texts_tooltip_text_rome2_tltip_main_enemy_minor_settlement	Enemy minor settlement	true
campaign_map_tooltip_texts_tooltip_text_rome2_tltip_warning_cannot_act_besieged_non_enemy	[[col:red]]Settlements that are under siege cannot be targeted.[[/col]]	true
campaign_map_tooltip_texts_tooltip_text_rome2_tltip_right_clk_disembark	Right-click to disembark	true
campaign_map_tooltip_texts_tooltip_text_rome2_tltip_main_non_player_agent	Neutral %S Hero	true
campaign_map_tooltip_texts_tooltip_text_rome2_tltip_right_clk_act_against_settlement_left_clk_select_inspection	Right-click to act
Left-click to inspect	true
campaign_map_tooltip_texts_tooltip_text_rome2_tltip_warning_settlement_under_siege	[[col:yellow]]This settlement is under siege[[/col]]	true
campaign_map_tooltip_texts_tooltip_text_rome2_tltip_must_break_blockade	Must break blockade first.	true
campaign_map_tooltip_texts_tooltip_text_wh2_main_tltip_non_player_blark	Neutral Black Ark	true
campaign_map_tooltip_texts_tooltip_text_rome2_tltip_main_player_admiral	Your fleet	true
campaign_map_tooltip_texts_tooltip_text_rome2_tltip_main_enemy_province_capital	Enemy province capital	true
campaign_map_tooltip_texts_tooltip_text_rome2_tltip_right_clk_embed_agent	Right-click to embed [[img:icon_hero]][[/img]]Hero	true
campaign_map_tooltip_texts_tooltip_text_rome2_tltip_main_player_general	Your army	true
campaign_map_tooltip_texts_tooltip_text_rome2_tltip_warning_cannot_attack_stance	[[col:red]]This army cannot attack in its current stance.[[/col]]	true
campaign_map_tooltip_texts_tooltip_text_rome2_tltip_right_clk_attack_settlement_left_clk_select_inspection	{{tr:rome2_tltip_right_clk_attack_settlement_left_clk_select_inspection}}	true
