Loc PackedFile
Key	Text	Tooltip
culture_settlement_occupation_options_tooltip_5586644	Occupy||{{tr:occupation_decision_occupy}}	true
culture_settlement_occupation_options_tooltip_3024063	Loot & Occupy||You gain wealth from looting, but buildings in the settlement are damaged. All captives are enslaved, [[img:icon_public_order]][[/img]]{{tr:hp_campaign_public_order_term}} is greatly reduced, and your diplomatic relations with the previous owner also suffer greatly.	true
culture_settlement_occupation_options_tooltip_1226602159	Colonise||Settle your troops.	true
culture_settlement_occupation_options_tooltip_1984548064	Resettle||With no regions currently under your control, you have the option to settle your army here.	true
culture_settlement_occupation_options_tooltip_1808714346	Resettle||With no regions currently under your control, you have the option to settle your army here.	true
culture_settlement_occupation_options_tooltip_1182397706	Do Nothing||Leave the settlement as it stands.	true
culture_settlement_occupation_options_tooltip_2053788775	Occupy||{{tr:occupation_decision_occupy}}	true
culture_settlement_occupation_options_tooltip_1842488273	Search Ruins||You will be presented with a puzzle to solve; you will be rewarded if you successfully decipher it.	true
culture_settlement_occupation_options_tooltip_1208400770	Loot & Occupy||You gain wealth from looting, but buildings in the settlement are damaged. All captives are enslaved, [[img:icon_public_order]][[/img]]{{tr:hp_campaign_public_order_term}} is greatly reduced, and your diplomatic relations with the previous owner also suffer greatly.	true
culture_settlement_occupation_options_tooltip_1381451274	Loot & Occupy||You gain wealth from looting, but buildings in the settlement are damaged. All captives are enslaved, [[img:icon_public_order]][[/img]]{{tr:hp_campaign_public_order_term}} is greatly reduced, and your diplomatic relations with the previous owner also suffer greatly.	true
culture_settlement_occupation_options_tooltip_2108916292	Resettle||With no regions currently under your control, you have the option to settle your army here.	true
culture_settlement_occupation_options_tooltip_1417668653	Do Nothing||Leave the settlement as it stands.	true
culture_settlement_occupation_options_tooltip_1508112825	Raze||All buildings are destroyed and the settlement is torched.	true
culture_settlement_occupation_options_tooltip_1044364106	Raze||All buildings are destroyed and the settlement is torched.	true
culture_settlement_occupation_options_tooltip_1554055236	Search Ruins||You will be presented with a puzzle to solve; you will be rewarded if you successfully decipher it.	true
culture_settlement_occupation_options_tooltip_1666688458	Search Ruins||You will be presented with a puzzle to solve; you will be rewarded if you successfully decipher it.	true
culture_settlement_occupation_options_tooltip_2137520555	Search Ruins||You will be presented with a puzzle to solve; you will be rewarded if you successfully decipher it.	true
culture_settlement_occupation_options_tooltip_1098319305	Sack||You do not capture the settlement but instead steal wealth and damage buildings. All captives are enslaved, [[img:icon_public_order]][[/img]]{{tr:hp_campaign_public_order_term}} is reduced, and the previous owners will like you a lot less.	true
culture_settlement_occupation_options_tooltip_1662205812	Do Nothing||Leave the settlement as it stands.	true
culture_settlement_occupation_options_tooltip_438	Seeding||{{tr:occupation_decision_occupy}}	true
culture_settlement_occupation_options_tooltip_939	Raze||All buildings are destroyed and the settlement is torched.	true
culture_settlement_occupation_options_tooltip_533	Resettle||With no regions currently under your control, you have the option to settle your army here.	true
culture_settlement_occupation_options_tooltip_930	Occupy||{{tr:occupation_decision_occupy}}	true
culture_settlement_occupation_options_tooltip_631	Sack||You do not capture the settlement but instead steal wealth and damage buildings. All captives are enslaved, [[img:icon_public_order]][[/img]]{{tr:hp_campaign_public_order_term}} is reduced, and the previous owners will like you a lot less.	true
culture_settlement_occupation_options_tooltip_731	Sack||You do not capture the settlement but instead steal wealth and damage buildings. All captives are enslaved, [[img:icon_public_order]][[/img]]{{tr:hp_campaign_public_order_term}} is reduced, and the previous owners will like you a lot less.	true
culture_settlement_occupation_options_tooltip_1827423963	Loot & Occupy||You gain wealth from looting, but buildings in the settlement are damaged. All captives are enslaved, [[img:icon_public_order]][[/img]]{{tr:hp_campaign_public_order_term}} is greatly reduced, and your diplomatic relations with the previous owner also suffer greatly.	true
culture_settlement_occupation_options_tooltip_1225481862	Raze||All buildings are destroyed and the settlement is torched.	true
culture_settlement_occupation_options_tooltip_1553738659	Do Nothing||Leave the settlement as it stands.	true
culture_settlement_occupation_options_tooltip_1914558271	Search Ruins||You will be presented with a puzzle to solve; you will be rewarded if you successfully decipher it.	true
culture_settlement_occupation_options_tooltip_1824195232	Raze for the Serpent||You raze this region and erect a monument to the Mighty Serpent.

Attaining allegiance to this God will reward you with the following:

[[col:green]]Level 1 - [[img:icon_upkeep]][[/img]]Upkeep: -10% for all units (all forces)

Level 2 - [[img:icon_army]][[/img]]Lord recruit rank: +5 (all provinces)[[/col]]

[[col:yellow]]Level 3 - [[img:icon_god_snake]][[/img]]A specialist Chaos sorcerer, Kihar the Tormentor, will be recruited to fight for your faction[[/col]]	true
culture_settlement_occupation_options_tooltip_1825327019	Resettle||With no regions currently under your control you have the option to settle your army here.	true
culture_settlement_occupation_options_tooltip_1124241207	Loot & Occupy||You gain wealth from looting, but buildings in the settlement are damaged. All captives are enslaved, [[img:icon_public_order]][[/img]]{{tr:hp_campaign_public_order_term}} is greatly reduced, and your diplomatic relations with the previous owner also suffer greatly.	true
culture_settlement_occupation_options_tooltip_1974097622	Raze||All buildings are destroyed and the settlement is torched.	true
culture_settlement_occupation_options_tooltip_1743729955	Sack||You do not capture the settlement but instead steal wealth and damage buildings. All captives are enslaved, [[img:icon_public_order]][[/img]]{{tr:hp_campaign_public_order_term}} is reduced, and the previous owners will like you a lot less.	true
culture_settlement_occupation_options_tooltip_1077702156	Search Ruins||You will be presented with a puzzle to solve, rewarding you if successfully deciphered.	true
culture_settlement_occupation_options_tooltip_1706263105	Raze||All buildings are destroyed and the settlement is torched.	true
culture_settlement_occupation_options_tooltip_2115816894	Raze||All buildings are destroyed and the settlement is torched.	true
culture_settlement_occupation_options_tooltip_422	Do Nothing||Leave the settlement as it stands.	true
culture_settlement_occupation_options_tooltip_626	Resettle||With no regions currently under your control, you have the option to settle your army here.	true
culture_settlement_occupation_options_tooltip_524	Occupy||{{tr:occupation_decision_occupy}}	true
culture_settlement_occupation_options_tooltip_724	Resettle||With no regions currently under your control, you have the option to settle your army here.	true
culture_settlement_occupation_options_tooltip_924	Loot & Occupy||You gain wealth from looting, but buildings in the settlement are damaged. All captives are enslaved, [[img:icon_public_order]][[/img]]{{tr:hp_campaign_public_order_term}} is greatly reduced, and your diplomatic relations with the previous owner also suffer greatly.	true
culture_settlement_occupation_options_tooltip_1069680572	Raze||All buildings are destroyed and the settlement is torched.	true
culture_settlement_occupation_options_tooltip_1175920989	Do Nothing||Leave the settlement as it stands.	true
culture_settlement_occupation_options_tooltip_1901422251	Resettle||With no regions currently under your control, you have the option to settle your army here.	true
culture_settlement_occupation_options_tooltip_1821216631	Colonise||Settle your troops.	true
culture_settlement_occupation_options_tooltip_1929126504	Raze||All buildings are destroyed and the settlement is torched.	true
culture_settlement_occupation_options_tooltip_1247959789	Loot & Occupy||You gain wealth from looting, but buildings in the settlement are damaged. All captives are enslaved, [[img:icon_public_order]][[/img]]{{tr:hp_campaign_public_order_term}} is greatly reduced, and your diplomatic relations with the previous owner also suffer greatly.	true
culture_settlement_occupation_options_tooltip_1644580143	Resettle||With no regions currently under your control, you have the option to settle your army here.	true
culture_settlement_occupation_options_tooltip_1895038916	Resettle||With no regions currently under your control, you have the option to settle your army here.	true
culture_settlement_occupation_options_tooltip_1339872098	Search Ruins||You will be presented with a puzzle to solve; you will be rewarded if you successfully decipher it.	true
culture_settlement_occupation_options_tooltip_1209597248	Colonise||Settle your troops.	true
culture_settlement_occupation_options_tooltip_1283642277	Resettle||With no regions currently under your control, you have the option to settle your army here.	true
culture_settlement_occupation_options_tooltip_1526347920	Loot & Occupy||You gain wealth from looting, but buildings in the settlement are damaged. All captives are enslaved, [[img:icon_public_order]][[/img]]{{tr:hp_campaign_public_order_term}} is greatly reduced, and your diplomatic relations with the previous owner also suffer greatly.	true
culture_settlement_occupation_options_tooltip_1572361422	Search Ruins||You will be presented with a puzzle to solve; you will be rewarded if you successfully decipher it.	true
culture_settlement_occupation_options_tooltip_1633455852	Search Ruins||You will be presented with a puzzle to solve; you will be rewarded if you successfully decipher it.	true
culture_settlement_occupation_options_tooltip_1278515543	Loot & Occupy||You gain wealth from looting, but buildings in the settlement are damaged. All captives are enslaved, [[img:icon_public_order]][[/img]]{{tr:hp_campaign_public_order_term}} is greatly reduced, and your diplomatic relations with the previous owner also suffer greatly.	true
culture_settlement_occupation_options_tooltip_1473405154	Occupy||{{tr:occupation_decision_occupy}}	true
culture_settlement_occupation_options_tooltip_1125371321	Occupy||{{tr:occupation_decision_occupy}}	true
culture_settlement_occupation_options_tooltip_1418174705	Raze||All buildings are destroyed and the settlement is torched.	true
culture_settlement_occupation_options_tooltip_1619019012	Occupy||{{tr:occupation_decision_occupy}}	true
culture_settlement_occupation_options_tooltip_2143540270	Raze||All buildings are destroyed and the settlement is torched.	true
culture_settlement_occupation_options_tooltip_1197909885	Raze||All buildings are destroyed and the settlement is torched.	true
culture_settlement_occupation_options_tooltip_2062600144	Resettle||With no regions currently under your control, you have the option to settle your army here.	true
culture_settlement_occupation_options_tooltip_419	Colonise||Settle your troops.	true
culture_settlement_occupation_options_tooltip_411	Raze & Defile||All buildings are destroyed, their shrines are defiled and the settlement is torched.	true
culture_settlement_occupation_options_tooltip_511	Do Nothing||Leave the settlement as it stands.	true
culture_settlement_occupation_options_tooltip_716	Raze||All buildings are destroyed and the settlement is torched.	true
culture_settlement_occupation_options_tooltip_617	Raze||All buildings are destroyed and the settlement is torched.	true
culture_settlement_occupation_options_tooltip_414	Sack||You do not capture the settlement but instead steal wealth and damage buildings. All captives are enslaved, [[img:icon_public_order]][[/img]]{{tr:hp_campaign_public_order_term}} is reduced, and the previous owners will like you a lot less.	true
culture_settlement_occupation_options_tooltip_915	Do Nothing||Leave the settlement as it stands.	true
culture_settlement_occupation_options_tooltip_1754768178	Search Ruins||You will be presented with a puzzle to solve; you will be rewarded if you successfully decipher it.	true
culture_settlement_occupation_options_tooltip_1859704771	Resettle||With no regions currently under your control, you have the option to settle your army here.	true
culture_settlement_occupation_options_tooltip_1871732775	Occupy||{{tr:occupation_decision_occupy}}	true
culture_settlement_occupation_options_tooltip_1646225429	Sack||You do not capture the settlement but instead steal wealth and damage buildings. All captives are enslaved, [[img:icon_public_order]][[/img]]{{tr:hp_campaign_public_order_term}} is reduced, and the previous owners will like you a lot less.	true
culture_settlement_occupation_options_tooltip_1355265129	Do Nothing||Leave the settlement as it stands.	true
culture_settlement_occupation_options_tooltip_1423703978	Search Ruins||You will be presented with a puzzle to solve; you will be rewarded if you successfully decipher it.	true
culture_settlement_occupation_options_tooltip_1186387039	Colonise||Settle your troops.	true
culture_settlement_occupation_options_tooltip_1256143616	Raze||All buildings are destroyed and the settlement is torched.	true
culture_settlement_occupation_options_tooltip_2064441370	Search Ruins||You will be presented with a puzzle to solve; you will be rewarded if you successfully decipher it.	true
culture_settlement_occupation_options_tooltip_408	Raze||All buildings are destroyed and the settlement is torched.	true
culture_settlement_occupation_options_tooltip_608	Occupy||{{tr:occupation_decision_occupy}}	true
culture_settlement_occupation_options_tooltip_802	Resettle||With no regions currently under your control, you have the option to settle your army here.	true
culture_settlement_occupation_options_tooltip_701	Loot & Occupy||You gain wealth from looting, but buildings in the settlement are damaged. All captives are enslaved, [[img:icon_public_order]][[/img]]{{tr:hp_campaign_public_order_term}} is greatly reduced, and your diplomatic relations with the previous owner also suffer greatly.	true
culture_settlement_occupation_options_tooltip_801	Raze||All buildings are destroyed and the settlement is torched.	true
culture_settlement_occupation_options_tooltip_406	Do Nothing||Leave the settlement as it stands.	true
culture_settlement_occupation_options_tooltip_906	Colonise||Settle your troops.	true
culture_settlement_occupation_options_tooltip_707	Occupy||{{tr:occupation_decision_occupy}}	true
culture_settlement_occupation_options_tooltip_404	Raze||All buildings are destroyed and the settlement is torched.	true
culture_settlement_occupation_options_tooltip_604	Loot & Occupy||You gain wealth from looting, but buildings in the settlement are damaged. All captives are enslaved, [[img:icon_public_order]][[/img]]{{tr:hp_campaign_public_order_term}} is greatly reduced, and your diplomatic relations with the previous owner also suffer greatly.	true
culture_settlement_occupation_options_tooltip_505	Colonise||Settle your troops.	true
culture_settlement_occupation_options_tooltip_805	Sack||You do not capture the settlement but instead steal wealth and damage buildings. All captives are enslaved, [[img:icon_public_order]][[/img]]{{tr:hp_campaign_public_order_term}} is reduced, and the previous owners will like you a lot less.	true
culture_settlement_occupation_options_tooltip_1722183266	Colonise||Settle your troops.	true
culture_settlement_occupation_options_tooltip_1877687819	Occupy||{{tr:occupation_decision_occupy}}	true
culture_settlement_occupation_options_tooltip_1121797200	Raze||All buildings are destroyed and the settlement is torched.	true
culture_settlement_occupation_options_tooltip_1654677519	Loot & Occupy||You gain wealth from looting, but buildings in the settlement are damaged. All captives are enslaved, [[img:icon_public_order]][[/img]]{{tr:hp_campaign_public_order_term}} is greatly reduced, and your diplomatic relations with the previous owner also suffer greatly.	true
culture_settlement_occupation_options_tooltip_2013679529	Search Ruins||You will be presented with a puzzle to solve; you will be rewarded if you successfully decipher it.	true
culture_settlement_occupation_options_tooltip_1968527227	Resettle||With no regions currently under your control, you have the option to settle your army here.	true
culture_settlement_occupation_options_tooltip_1372413533	Raze||All buildings are destroyed and the settlement is torched.	true
culture_settlement_occupation_options_tooltip_1655500920	Search Ruins||You will be presented with a puzzle to solve; you will be rewarded if you successfully decipher it.	true
culture_settlement_occupation_options_tooltip_2091577911	Search Ruins||You will be presented with a puzzle to solve; you will be rewarded if you successfully decipher it.	true
culture_settlement_occupation_options_tooltip_1343564720	Resettle||With no regions currently under your control, you have the option to settle your army here.	true
culture_settlement_occupation_options_tooltip_1771126560	Search Ruins||You will be presented with a puzzle to solve; you will be rewarded if you successfully decipher it.	true
culture_settlement_occupation_options_tooltip_1552378746	Occupy||{{tr:occupation_decision_occupy}}	true
culture_settlement_occupation_options_tooltip_2048728336	Sack||You do not capture the settlement but instead steal wealth and damage buildings. All captives are enslaved, [[img:icon_public_order]][[/img]]{{tr:hp_campaign_public_order_term}} is reduced, and the previous owners will like you a lot less.	true
culture_settlement_occupation_options_tooltip_579	Subjugate||You become the master of the conquered faction, and they become your vassal, paying tribute each turn. All captives are enslaved.	true
culture_settlement_occupation_options_tooltip_679	Sack||You do not capture the settlement but instead steal wealth and damage buildings. All captives are enslaved, [[img:icon_public_order]][[/img]]{{tr:hp_campaign_public_order_term}} is reduced, and the previous owners will like you a lot less.	true
culture_settlement_occupation_options_tooltip_673	Resettle||With no regions currently under your control, you have the option to settle your army here.	true
culture_settlement_occupation_options_tooltip_570	Raze||All buildings are destroyed and the settlement is torched.	true
culture_settlement_occupation_options_tooltip_576	Loot & Raze||You do not occupy the settlement but instead steal its wealth and torch the place.	true
culture_settlement_occupation_options_tooltip_777	Colonise||Settle your troops.	true
culture_settlement_occupation_options_tooltip_874	Occupy||{{tr:occupation_decision_occupy}}	true
culture_settlement_occupation_options_tooltip_1964012767	Do Nothing||Leave the settlement as it stands.	true
culture_settlement_occupation_options_tooltip_1520670401	Loot & Occupy||You gain wealth from looting, but buildings in the settlement are damaged. All captives are enslaved, [[img:icon_public_order]][[/img]]{{tr:hp_campaign_public_order_term}} is greatly reduced, and your diplomatic relations with the previous owner also suffer greatly.	true
culture_settlement_occupation_options_tooltip_1487524636	Do Nothing||Leave the settlement as it stands.	true
culture_settlement_occupation_options_tooltip_1972364658	Loot & Occupy||You gain wealth from looting, but buildings in the settlement are damaged. All captives are enslaved, [[img:icon_public_order]][[/img]]{{tr:hp_campaign_public_order_term}} is greatly reduced, and your diplomatic relations with the previous owner also suffer greatly.	true
culture_settlement_occupation_options_tooltip_2017371061	Occupy||{{tr:occupation_decision_occupy}}	true
culture_settlement_occupation_options_tooltip_2001701324	Search Ruins||You will be presented with a puzzle to solve; you will be rewarded if you successfully decipher it.	true
culture_settlement_occupation_options_tooltip_662	Occupy||{{tr:occupation_decision_occupy}}	true
culture_settlement_occupation_options_tooltip_563	Awaken Tribe||You summon the original Norse tribe that once wandered this region, resurrecting their faction. All captives are enslaved.

They will be immensely grateful for this, offering their services as a [[img:icon_vassal]][[/img]]vassal.	true
culture_settlement_occupation_options_tooltip_860	Do Nothing||Leave the settlement as it stands.	true
culture_settlement_occupation_options_tooltip_866	Loot & Occupy||You gain wealth from looting, but buildings in the settlement are damaged. All captives are enslaved, [[img:icon_public_order]][[/img]]{{tr:hp_campaign_public_order_term}} is greatly reduced, and your diplomatic relations with the previous owner also suffer greatly.	true
culture_settlement_occupation_options_tooltip_367	Raze||All buildings are destroyed and the settlement is torched.	true
culture_settlement_occupation_options_tooltip_664	Raze||All buildings are destroyed and the settlement is torched.	true
culture_settlement_occupation_options_tooltip_965	Subjugate||You become the master of the conquered faction, and they become your vassal, paying tribute each turn. All captives are enslaved.	true
culture_settlement_occupation_options_tooltip_1039534208	Do Nothing||Leave the settlement as it stands.	true
culture_settlement_occupation_options_tooltip_2102037769	Resettle||With no regions currently under your control, you have the option to settle your army here.	true
culture_settlement_occupation_options_tooltip_1744087855	Sack||You do not capture the settlement but instead steal wealth and damage buildings. All captives are enslaved, [[img:icon_public_order]][[/img]]{{tr:hp_campaign_public_order_term}} is reduced, and the previous owners will like you a lot less.	true
culture_settlement_occupation_options_tooltip_1942353263	Loot & Occupy||You gain wealth from looting, but buildings in the settlement are damaged. All captives are enslaved, [[img:icon_public_order]][[/img]]{{tr:hp_campaign_public_order_term}} is greatly reduced, and your diplomatic relations with the previous owner also suffer greatly.	true
culture_settlement_occupation_options_tooltip_1453062951	Colonise||Settle your troops.	true
culture_settlement_occupation_options_tooltip_1603532907	Occupy||{{tr:occupation_decision_occupy}}	true
culture_settlement_occupation_options_tooltip_1773140841	Colonise||Settle your troops.	true
culture_settlement_occupation_options_tooltip_1118618530	Resettle||With no regions currently under your control, you have the option to settle your army here.	true
culture_settlement_occupation_options_tooltip_1294427310	Resettle||With no regions currently under your control, you have the option to settle your army here.	true
culture_settlement_occupation_options_tooltip_1425726926	Raze||All buildings are destroyed and the settlement is torched.	true
culture_settlement_occupation_options_tooltip_1518225177	Loot & Occupy||You gain wealth from looting, but buildings in the settlement are damaged. All captives are enslaved, [[img:icon_public_order]][[/img]]{{tr:hp_campaign_public_order_term}} is greatly reduced, and your diplomatic relations with the previous owner also suffer greatly.	true
culture_settlement_occupation_options_tooltip_1653456014	Resettle||With no regions currently under your control, you have the option to settle your army here.	true
culture_settlement_occupation_options_tooltip_2079314256	Colonise||Settle your troops.	true
culture_settlement_occupation_options_tooltip_1098670633	Resettle||With no regions currently under your control, you have the option to settle your army here.	true
culture_settlement_occupation_options_tooltip_1181473512	Colonise||Settle your troops.	true
culture_settlement_occupation_options_tooltip_658	Loot & Occupy||You gain wealth from looting, but buildings in the settlement are damaged. All captives are enslaved, [[img:icon_public_order]][[/img]]{{tr:hp_campaign_public_order_term}} is greatly reduced, and your diplomatic relations with the previous owner also suffer greatly.	true
culture_settlement_occupation_options_tooltip_859	Colonise||Settle your troops.	true
culture_settlement_occupation_options_tooltip_450	Sack||You do not capture the settlement but instead steal wealth and damage buildings. All captives are enslaved, [[img:icon_public_order]][[/img]]{{tr:hp_campaign_public_order_term}} is reduced, and the previous owners will like you a lot less.	true
culture_settlement_occupation_options_tooltip_650	Do Nothing||Leave the settlement as it stands.	true
culture_settlement_occupation_options_tooltip_956	Sack||You do not capture the settlement but instead steal wealth and damage buildings. All captives are enslaved, [[img:icon_public_order]][[/img]]{{tr:hp_campaign_public_order_term}} is reduced, and the previous owners will like you a lot less.	true
culture_settlement_occupation_options_tooltip_555	Do Nothing||Leave the settlement as it stands.	true
culture_settlement_occupation_options_tooltip_1499350478	Do Nothing||Leave the settlement as it stands.	true
culture_settlement_occupation_options_tooltip_1067077346	Colonise||Settle your troops.	true
culture_settlement_occupation_options_tooltip_1149770737	Loot & Occupy||You gain wealth from looting, but buildings in the settlement are damaged. All captives are enslaved, [[img:icon_public_order]][[/img]]{{tr:hp_campaign_public_order_term}} is greatly reduced, and your diplomatic relations with the previous owner also suffer greatly.	true
culture_settlement_occupation_options_tooltip_2135671210	Resettle||With no regions currently under your control, you have the option to settle your army here.	true
culture_settlement_occupation_options_tooltip_1284562911	Loot & Occupy||You gain wealth from looting, but buildings in the settlement are damaged. All captives are enslaved, [[img:icon_public_order]][[/img]]{{tr:hp_campaign_public_order_term}} is greatly reduced, and your diplomatic relations with the previous owner also suffer greatly.	true
culture_settlement_occupation_options_tooltip_1529750034	Search Ruins||You will be presented with a puzzle to solve; you will be rewarded if you successfully decipher it.	true
culture_settlement_occupation_options_tooltip_1963655228	Raze for the Hound||You raze this region and erect a monument to the Great Hound.

Attaining allegiance to this God will reward you with the following:

[[col:green]]Level 1 - [[img:icon_weapon_damage]][[/img]]Weapon strength: +10% for melee infantry units (all forces)

Level 2 - [[img:icon_xp]][[/img]]Unit experience gain per turn: +100 (all forces)[[/col]]

[[col:yellow]]Level 3 - [[img:icon_god_hound]][[/img]]A unique and extremely powerful Hellcannon unit, the Ice-Forged Legion, will become available for recruitment[[/col]].	true
culture_settlement_occupation_options_tooltip_948	Resettle||With no regions currently under your control, you have the option to settle your army here.	true
culture_settlement_occupation_options_tooltip_442	Resettle||With no regions currently under your control, you have the option to settle your army here.	true
culture_settlement_occupation_options_tooltip_643	Colonise||Settle your troops.	true
culture_settlement_occupation_options_tooltip_441	Raze||All buildings are destroyed and the settlement is torched.	true
culture_settlement_occupation_options_tooltip_1897978920	Sack||You do not capture the settlement but instead steal wealth and damage buildings. All captives are enslaved, [[img:icon_public_order]][[/img]]{{tr:hp_campaign_public_order_term}} is reduced, and the previous owners will like you a lot less.	true
culture_settlement_occupation_options_tooltip_1861824734	Sack||You do not capture the settlement but instead steal wealth and damage buildings. All captives are enslaved, [[img:icon_public_order]][[/img]]{{tr:hp_campaign_public_order_term}} is reduced, and the previous owners will like you a lot less.	true
culture_settlement_occupation_options_tooltip_1262847535	Sack||You do not capture the settlement but instead steal wealth and damage buildings. All captives are enslaved, [[img:icon_public_order]][[/img]]{{tr:hp_campaign_public_order_term}} is reduced, and the previous owners will like you a lot less.	true
culture_settlement_occupation_options_tooltip_1422314686	Raze||All buildings are destroyed and the settlement is torched.	true
culture_settlement_occupation_options_tooltip_1446313985	Colonise||Settle your troops.	true
culture_settlement_occupation_options_tooltip_1495904824	Search Ruins||You will be presented with a puzzle to solve; you will be rewarded if you successfully decipher it.	true
culture_settlement_occupation_options_tooltip_1741375880	Loot & Occupy||You gain wealth from looting, but buildings in the settlement are damaged. All captives are enslaved, [[img:icon_public_order]][[/img]]{{tr:hp_campaign_public_order_term}} is greatly reduced, and your diplomatic relations with the previous owner also suffer greatly.	true
culture_settlement_occupation_options_tooltip_1336971323	Occupy||{{tr:occupation_decision_occupy}}	true
culture_settlement_occupation_options_tooltip_1966857726	Colonise||Settle your troops.	true
culture_settlement_occupation_options_tooltip_1130897820	Sack||You do not capture the settlement but instead steal wealth and damage buildings. All captives are enslaved, [[img:icon_public_order]][[/img]]{{tr:hp_campaign_public_order_term}} is reduced, and the previous owners will like you a lot less.	true
culture_settlement_occupation_options_tooltip_1636300599	Sack||You do not capture the settlement but instead steal wealth and damage buildings. All captives are enslaved, [[img:icon_public_order]][[/img]]{{tr:hp_campaign_public_order_term}} is reduced, and the previous owners will like you a lot less.	true
culture_settlement_occupation_options_tooltip_1310207980	Sack||You do not capture the settlement but instead steal wealth and damage buildings. All captives are enslaved, [[img:icon_public_order]][[/img]]{{tr:hp_campaign_public_order_term}} is reduced, and the previous owners will like you a lot less.	true
culture_settlement_occupation_options_tooltip_1874397997	Colonise||Settle your troops.	true
culture_settlement_occupation_options_tooltip_1011188887	Raze||All buildings are destroyed and the settlement is torched.	true
culture_settlement_occupation_options_tooltip_1269866319	Resettle||With no regions currently under your control, you have the option to settle your army here.	true
culture_settlement_occupation_options_tooltip_1726885913	Colonise||Settle your troops.	true
culture_settlement_occupation_options_tooltip_2141395194	Resettle||With no regions currently under your control, you have the option to settle your army here.	true
culture_settlement_occupation_options_tooltip_691	Colonise||Settle your troops.	true
culture_settlement_occupation_options_tooltip_791	Loot & Occupy||You gain wealth from looting, but buildings in the settlement are damaged. All captives are enslaved, [[img:icon_public_order]][[/img]]{{tr:hp_campaign_public_order_term}} is greatly reduced, and your diplomatic relations with the previous owner also suffer greatly.	true
culture_settlement_occupation_options_tooltip_596	Do Nothing||Leave the settlement as it stands.	true
culture_settlement_occupation_options_tooltip_694	Do Nothing||Leave the settlement as it stands.	true
culture_settlement_occupation_options_tooltip_794	Occupy||{{tr:occupation_decision_occupy}}	true
culture_settlement_occupation_options_tooltip_695	Gift||The settlement is captured and gifted to another faction.	true
culture_settlement_occupation_options_tooltip_895	Sack||You do not capture the settlement but instead steal wealth and damage buildings. All captives are enslaved, [[img:icon_public_order]][[/img]]{{tr:hp_campaign_public_order_term}} is reduced, and the previous owners will like you a lot less.	true
culture_settlement_occupation_options_tooltip_1138195892	Loot & Occupy||You gain wealth from looting, but buildings in the settlement are damaged. All captives are enslaved, [[img:icon_public_order]][[/img]]{{tr:hp_campaign_public_order_term}} is greatly reduced, and your diplomatic relations with the previous owner also suffer greatly.	true
culture_settlement_occupation_options_tooltip_1840895909	Search Ruins||You will be presented with a puzzle to solve; you will be rewarded if you successfully decipher it.	true
culture_settlement_occupation_options_tooltip_1369123792	Raze for the Crow||You raze this region and erect a monument to the Great Crow.

Attaining allegiance to this God will reward you with the following:

[[col:green]]Level 1 - [[img:icon_casualty_replenishment]][[/img]]Casualty replenishment rate: +20% (all forces)

Level 2 - [[img:icon_wound]][[/img]]Wound recovery time: -4 (all characters)[[/col]]

[[col:yellow]]Level 3 - [[img:icon_god_crow]][[/img]]A devastating plague will be unleashed across the world (your faction being immune)[[/col]]	true
culture_settlement_occupation_options_tooltip_1046022784	Do Nothing||Leave the settlement as it stands.	true
culture_settlement_occupation_options_tooltip_1507055186	Sack||You do not capture the settlement but instead steal wealth and damage buildings. All captives are enslaved, [[img:icon_public_order]][[/img]]{{tr:hp_campaign_public_order_term}} is reduced, and the previous owners will like you a lot less.	true
culture_settlement_occupation_options_tooltip_588	Colonise||Settle your troops.	true
culture_settlement_occupation_options_tooltip_889	Resettle||With no regions currently under your control, you have the option to settle your army here.	true
culture_settlement_occupation_options_tooltip_883	Raze||All buildings are destroyed and the settlement is torched.	true
culture_settlement_occupation_options_tooltip_386	Sack||You do not capture the settlement but instead steal wealth and damage buildings. All captives are enslaved, [[img:icon_public_order]][[/img]]{{tr:hp_campaign_public_order_term}} is reduced, and the previous owners will like you a lot less.	true
culture_settlement_occupation_options_tooltip_784	Do Nothing||Leave the settlement as it stands.	true
culture_settlement_occupation_options_tooltip_1834852874	Occupy||{{tr:occupation_decision_occupy}}	true
culture_settlement_occupation_options_tooltip_1595781982	Occupy||You occupy this settlement.	true
culture_settlement_occupation_options_tooltip_1186759489	Sack||You do not capture the settlement but instead steal wealth and damage buildings. All captives are enslaved, [[img:icon_public_order]][[/img]]{{tr:hp_campaign_public_order_term}} is reduced, and the previous owners will like you a lot less.	true
culture_settlement_occupation_options_tooltip_1292694896	Raze for the Eagle||You raze this region and erect a monument to the Great Eagle.

Attaining allegiance to this God will reward you with the following:

[[col:green]]Level 1 - [[img:icon_tech]][[/img]]Research rate: +20%

Level 2 - [[img:icon_magic]][[/img]]Winds of Magic starting amount: +20 (all forces)[[/col]]

[[col:yellow]]Level 3 - [[img:icon_god_eagle]][[/img]]A mighty Lord of Change, Azrik the Maze Keeper, will be unlocked to fight for your faction[[/col]]	true
culture_settlement_occupation_options_tooltip_1342765684	Do Nothing||Leave the settlement as it stands.	true
culture_settlement_occupation_options_tooltip_1118716587	Search Ruins||You will be presented with a puzzle to solve, rewarding you if successfully deciphered.	true
culture_settlement_occupation_options_tooltip_2054849241	Colonise||Settle your troops.	true
culture_settlement_occupation_options_tooltip_1179690881	Sack||You do not capture the settlement but instead steal wealth and damage buildings. All captives are enslaved, [[img:icon_public_order]][[/img]]{{tr:hp_campaign_public_order_term}} is reduced, and the previous owners will like you a lot less.	true
culture_settlement_occupation_options_tooltip_1916974677	Loot & Occupy||You gain wealth from looting, but buildings in the settlement are damaged. All captives are enslaved, [[img:icon_public_order]][[/img]]{{tr:hp_campaign_public_order_term}} is greatly reduced, and your diplomatic relations with the previous owner also suffer greatly.	true
culture_settlement_occupation_options_tooltip_2093904449	Occupy||{{tr:occupation_decision_occupy}}	true
culture_settlement_occupation_options_tooltip_1435925179	Do Nothing||Leave the settlement as it stands.	true
culture_settlement_occupation_options_tooltip_1093752699	Search Ruins||You will be presented with a puzzle to solve, rewarding you if successfully deciphered.	true
culture_settlement_occupation_options_tooltip_1803832869	Loot & Occupy||You gain wealth from looting, but buildings in the settlement are damaged. All captives are enslaved, [[img:icon_public_order]][[/img]]{{tr:hp_campaign_public_order_term}} is greatly reduced, and your diplomatic relations with the previous owner also suffer greatly.	true
culture_settlement_occupation_options_tooltip_1071724693	Sack||You do not capture the settlement but instead steal wealth and damage buildings. All captives are enslaved, [[img:icon_public_order]][[/img]]{{tr:hp_campaign_public_order_term}} is reduced, and the previous owners will like you a lot less.	true
culture_settlement_occupation_options_tooltip_1117484992	Search Ruins||You will be presented with a puzzle to solve, rewarding you if successfully deciphered.	true
culture_settlement_occupation_options_tooltip_1764888954	Sack||You do not capture the settlement but instead steal wealth and damage buildings. All captives are enslaved, [[img:icon_public_order]][[/img]]{{tr:hp_campaign_public_order_term}} is reduced, and the previous owners will like you a lot less.	true
culture_settlement_occupation_options_tooltip_1479882951	Sack||You do not capture the settlement but instead steal wealth and damage buildings. All captives are enslaved, [[img:icon_public_order]][[/img]]{{tr:hp_campaign_public_order_term}} is reduced, and the previous owners will like you a lot less.	true
culture_settlement_occupation_options_tooltip_1043553186	Establish Outpost||You occupy this settlement and establish a Norscan Outpost there.	true
culture_settlement_occupation_options_tooltip_1088457096	Colonise||Settle your troops	true
culture_settlement_occupation_options_tooltip_1480477992	Search Ruins||You will be presented with a puzzle to solve; you will be rewarded if you successfully decipher it.	true
culture_settlement_occupation_options_tooltip_1985585985	Search Ruins||You will be presented with a puzzle to solve; you will be rewarded if you successfully decipher it.	true
culture_settlement_occupation_options_tooltip_1822456386	Do Nothing||Leave the settlement as it stands.	true
culture_settlement_occupation_options_tooltip_1838434180	Resettle||With no regions currently under your control, you have the option to settle your army here.	true
culture_settlement_occupation_options_tooltip_1231933158	Occupy||{{tr:occupation_decision_occupy}}	true
culture_settlement_occupation_options_tooltip_1858477980	Do Nothing||Leave the settlement as it stands.	true
culture_settlement_occupation_options_tooltip_1074998157	Do Nothing||Leave the settlement as it stands.	true
culture_settlement_occupation_options_tooltip_1962817245	Sack||You do not capture the settlement but instead steal wealth and damage buildings. All captives are enslaved, [[img:icon_public_order]][[/img]]{{tr:hp_campaign_public_order_term}} is reduced, and the previous owners will like you a lot less.	true
culture_settlement_occupation_options_tooltip_1995518499	Colonise||Settle your troops.	true
culture_settlement_occupation_options_tooltip_1791445083	Search Ruins||You will be presented with a puzzle to solve; you will be rewarded if you successfully decipher it.	true
culture_settlement_occupation_options_tooltip_1686826343	Colonise||Settle your troops.	true
culture_settlement_occupation_options_tooltip_1775491988	Occupy||{{tr:occupation_decision_occupy}}	true
culture_settlement_occupation_options_tooltip_1007846341	Colonise||Settle your troops.	true
culture_settlement_occupation_options_tooltip_74483760	Do Nothing||Leave the settlement as it stands.	true
culture_settlement_occupation_options_tooltip_37154126	Resettle||With no regions currently under your control, you have the option to settle your army here.	true
culture_settlement_occupation_options_tooltip_11579669	Sack||You do not capture the settlement but instead steal wealth and damage buildings. All captives are enslaved, [[img:icon_public_order]][[/img]]{{tr:hp_campaign_public_order_term}} is reduced, and the previous owners will like you a lot less.	true
culture_settlement_occupation_options_tooltip_73066103	Raze||All buildings are destroyed and the settlement is torched.	true
culture_settlement_occupation_options_tooltip_87057800	Establish Ruined Outpost||You occupy this ruin and establish a Ruined Outpost there.	true
culture_settlement_occupation_options_tooltip_93506440	Subjugate||You become the master of the conquered faction and they become your vassal, paying tribute each turn. All captives are enslaved.	true
culture_settlement_occupation_options_tooltip_57148878	Resettle||With no regions currently under your control, you have the option to settle your army here.	true
culture_settlement_occupation_options_tooltip_23289940	Colonise||Settle your troops.	true
culture_settlement_occupation_options_tooltip_69149356	Loot & Occupy||You gain wealth from looting, but buildings in the settlement are damaged. All captives are enslaved, [[img:icon_public_order]][[/img]]{{tr:hp_campaign_public_order_term}} is greatly reduced, and your diplomatic relations with the previous owner also suffer greatly.	true
culture_settlement_occupation_options_tooltip_33010856	Resettle||With no regions currently under your control, you have the option to settle your army here.	true
culture_settlement_occupation_options_tooltip_95325896	Raze||All buildings are destroyed and the settlement is torched.	true
culture_settlement_occupation_options_tooltip_17282989	Occupy||{{tr:occupation_decision_occupy}}	true
culture_settlement_occupation_options_tooltip_32348480	Sack||You do not capture the settlement but instead steal wealth and damage buildings. All captives are enslaved, [[img:icon_public_order]][[/img]]{{tr:hp_campaign_public_order_term}} is reduced, and the previous owners will like you a lot less.	true
culture_settlement_occupation_options_tooltip_74943519	Sack||You do not capture the settlement but instead steal wealth and damage buildings. All captives are enslaved, [[img:icon_public_order]][[/img]]{{tr:hp_campaign_public_order_term}} is reduced, and the previous owners will like you a lot less.	true
culture_settlement_occupation_options_tooltip_14994909	Raze||All buildings are destroyed and the settlement is torched.	true
culture_settlement_occupation_options_tooltip_93823244	Colonise||Settle your troops.	true
culture_settlement_occupation_options_tooltip_50579092	Loot & Occupy||You gain wealth from looting, but buildings in the settlement are damaged. All captives are enslaved, [[img:icon_public_order]][[/img]]{{tr:hp_campaign_public_order_term}} is greatly reduced, and your diplomatic relations with the previous owner also suffer greatly.	true
culture_settlement_occupation_options_tooltip_82467094	Sack||You do not capture the settlement but instead steal wealth and damage buildings. All captives are enslaved, [[img:icon_public_order]][[/img]]{{tr:hp_campaign_public_order_term}} is reduced, and the previous owners will like you a lot less.	true
culture_settlement_occupation_options_tooltip_828902462	Loot & Occupy||You gain wealth from looting, but buildings in the settlement are damaged. All captives are enslaved, [[img:icon_public_order]][[/img]]{{tr:hp_campaign_public_order_term}} is greatly reduced, and your diplomatic relations with the previous owner also suffer greatly.	true
culture_settlement_occupation_options_tooltip_426649498	Do Nothing||Leave the settlement as it stands.	true
culture_settlement_occupation_options_tooltip_833826373	Raze||All buildings are destroyed and the settlement is torched.	true
culture_settlement_occupation_options_tooltip_960846971	Search Ruins||You will be presented with a puzzle to solve; you will be rewarded if you successfully decipher it.	true
culture_settlement_occupation_options_tooltip_635674593	Search Ruins||You will be presented with a puzzle to solve; you will be rewarded if you successfully decipher it.	true
culture_settlement_occupation_options_tooltip_537860062	Search Ruins||You will be presented with a puzzle to solve; you will be rewarded if you successfully decipher it.	true
culture_settlement_occupation_options_tooltip_840978979	Sack||You do not capture the settlement but instead steal wealth and damage buildings. All captives are enslaved, [[img:icon_public_order]][[/img]]{{tr:hp_campaign_public_order_term}} is reduced, and the previous owners will like you a lot less.	true
culture_settlement_occupation_options_tooltip_756628881	Occupy||{{tr:occupation_decision_occupy}}	true
culture_settlement_occupation_options_tooltip_360748892	Loot & Occupy||You gain wealth from looting, but buildings in the settlement are damaged. All captives are enslaved, [[img:icon_public_order]][[/img]]{{tr:hp_campaign_public_order_term}} is greatly reduced, and your diplomatic relations with the previous owner also suffer greatly.	true
culture_settlement_occupation_options_tooltip_130994842	Sack||You do not capture the settlement but instead steal wealth and damage buildings. All captives are enslaved, [[img:icon_public_order]][[/img]]{{tr:hp_campaign_public_order_term}} is reduced, and the previous owners will like you a lot less.	true
culture_settlement_occupation_options_tooltip_364882552	Sack||You do not capture the settlement but instead steal wealth and damage buildings. All captives are enslaved, [[img:icon_public_order]][[/img]]{{tr:hp_campaign_public_order_term}} is reduced, and the previous owners will like you a lot less.	true
culture_settlement_occupation_options_tooltip_312540687	Do Nothing||Leave the settlement as it stands.	true
culture_settlement_occupation_options_tooltip_401551086	Colonise||Settle your troops.	true
culture_settlement_occupation_options_tooltip_865416480	Occupy||{{tr:occupation_decision_occupy}}	true
culture_settlement_occupation_options_tooltip_925419284	Occupy||{{tr:occupation_decision_occupy}}	true
culture_settlement_occupation_options_tooltip_210831043	Raze||All buildings are destroyed and the settlement is torched.	true
culture_settlement_occupation_options_tooltip_122551995	Sack||You do not capture the settlement but instead steal wealth and damage buildings. All captives are enslaved, [[img:icon_public_order]][[/img]]{{tr:hp_campaign_public_order_term}} is reduced, and the previous owners will like you a lot less.	true
culture_settlement_occupation_options_tooltip_759801046	Loot & Occupy||You gain wealth from looting, but buildings in the settlement are damaged. All captives are enslaved, [[img:icon_public_order]][[/img]]{{tr:hp_campaign_public_order_term}} is greatly reduced, and your diplomatic relations with the previous owner also suffer greatly.	true
culture_settlement_occupation_options_tooltip_389959751	Search Ruins||You will be presented with a puzzle to solve; you will be rewarded if you successfully decipher it.	true
culture_settlement_occupation_options_tooltip_573886648	Resettle||With no regions currently under your control, you have the option to settle your army here.	true
culture_settlement_occupation_options_tooltip_337857139	Sack||You do not capture the settlement but instead steal wealth and damage buildings. All captives are enslaved, [[img:icon_public_order]][[/img]]{{tr:hp_campaign_public_order_term}} is reduced, and the previous owners will like you a lot less.	true
culture_settlement_occupation_options_tooltip_747235696	Sack||You do not capture the settlement but instead steal wealth and damage buildings. All captives are enslaved, [[img:icon_public_order]][[/img]]{{tr:hp_campaign_public_order_term}} is reduced, and the previous owners will like you a lot less.	true
culture_settlement_occupation_options_tooltip_647377081	Raze||All buildings are destroyed and the settlement is torched.	true
culture_settlement_occupation_options_tooltip_420299699	Search Ruins||You will be presented with a puzzle to solve; you will be rewarded if you successfully decipher it.	true
culture_settlement_occupation_options_tooltip_567347385	Do Nothing||Leave the settlement as it stands.	true
culture_settlement_occupation_options_tooltip_540341284	Raze||All buildings are destroyed and the settlement is torched.	true
culture_settlement_occupation_options_tooltip_309208588	Resettle||With no regions currently under your control, you have the option to settle your army here.	true
culture_settlement_occupation_options_tooltip_617830228	Raze||All buildings are destroyed and the settlement is torched.	true
culture_settlement_occupation_options_tooltip_684880729	Do Nothing||Leave the settlement as it stands.	true
culture_settlement_occupation_options_tooltip_829993035	Raze||All buildings are destroyed and the settlement is torched.	true
culture_settlement_occupation_options_tooltip_870148585	Occupy||{{tr:occupation_decision_occupy}}	true
culture_settlement_occupation_options_tooltip_518942702	Sack||You do not occupy the settlement but instead steal wealth and damage buildings. All captives are killed.||[[img:icon_public_order]][[/img]]{{tr:public_order}} is reduced and the previous owners will like you a lot less.	true
culture_settlement_occupation_options_tooltip_273949402	Resettle||With no regions currently under your control, you have the option to settle your army here.	true
culture_settlement_occupation_options_tooltip_138988815	Resettle||With no regions currently under your control, you have the option to settle your army here.	true
culture_settlement_occupation_options_tooltip_518969511	Colonise||Settle your troops.	true
culture_settlement_occupation_options_tooltip_338811607	Colonise||Settle your troops.	true
culture_settlement_occupation_options_tooltip_602187865	Raze||All buildings are destroyed and the settlement is torched.	true
culture_settlement_occupation_options_tooltip_877613312	Colonise||Settle your troops.	true
culture_settlement_occupation_options_tooltip_902372745	Colonise||Settle your troops.	true
culture_settlement_occupation_options_tooltip_411094373	Resettle||With no regions currently under your control, you have the option to settle your army here.	true
culture_settlement_occupation_options_tooltip_960009275	Occupy||{{tr:occupation_decision_occupy}}	true
culture_settlement_occupation_options_tooltip_157027072	Loot & Occupy||You gain wealth from looting, but buildings in the settlement are damaged. All captives are enslaved, [[img:icon_public_order]][[/img]]{{tr:hp_campaign_public_order_term}} is greatly reduced, and your diplomatic relations with the previous owner also suffer greatly.	true
culture_settlement_occupation_options_tooltip_241004773	Do Nothing||Leave the settlement as it stands.	true
culture_settlement_occupation_options_tooltip_578356147	Raze||All buildings are destroyed and the settlement is torched.	true
culture_settlement_occupation_options_tooltip_727417632	Search Ruins||You will be presented with a puzzle to solve; you will be rewarded if you successfully decipher it.	true
culture_settlement_occupation_options_tooltip_766765905	Do Nothing||Leave the settlement as it stands.	true
culture_settlement_occupation_options_tooltip_667607113	Resettle||With no regions currently under your control, you have the option to settle your army here.	true
culture_settlement_occupation_options_tooltip_693790515	Sack||You do not capture the settlement but instead steal wealth and damage buildings. All captives are enslaved, [[img:icon_public_order]][[/img]]{{tr:hp_campaign_public_order_term}} is reduced, and the previous owners will like you a lot less.	true
culture_settlement_occupation_options_tooltip_349035968	Occupy||{{tr:occupation_decision_occupy}}	true
culture_settlement_occupation_options_tooltip_479032568	Loot & Occupy||You gain wealth from looting, but buildings in the settlement are damaged. All captives are enslaved, [[img:icon_public_order]][[/img]]{{tr:hp_campaign_public_order_term}} is greatly reduced, and your diplomatic relations with the previous owner also suffer greatly.	true
culture_settlement_occupation_options_tooltip_713002568	Occupy||{{tr:occupation_decision_occupy}}	true
culture_settlement_occupation_options_tooltip_676695902	Sack||You do not capture the settlement but instead steal wealth and damage buildings. All captives are enslaved, [[img:icon_public_order]][[/img]]{{tr:hp_campaign_public_order_term}} is reduced, and the previous owners will like you a lot less.	true
culture_settlement_occupation_options_tooltip_860350450	Resettle||With no regions currently under your control, you have the option to settle your army here.	true
culture_settlement_occupation_options_tooltip_175329851	Do Nothing||Leave the settlement as it stands.	true
culture_settlement_occupation_options_tooltip_518560131	Sack||You do not capture the settlement but instead steal wealth and damage buildings. All captives are enslaved, [[img:icon_public_order]][[/img]]{{tr:hp_campaign_public_order_term}} is reduced, and the previous owners will like you a lot less.	true
culture_settlement_occupation_options_tooltip_511624104	Loot & Occupy||You gain wealth from looting, but buildings in the settlement are damaged. All captives are enslaved, [[img:icon_public_order]][[/img]]{{tr:hp_campaign_public_order_term}} is greatly reduced, and your diplomatic relations with the previous owner also suffer greatly.	true
culture_settlement_occupation_options_tooltip_174558334	Loot & Occupy||You gain wealth from looting, but buildings in the settlement are damaged. All captives are enslaved, [[img:icon_public_order]][[/img]]{{tr:hp_campaign_public_order_term}} is greatly reduced, and your diplomatic relations with the previous owner also suffer greatly.	true
culture_settlement_occupation_options_tooltip_552131776	Colonise||Settle your troops.	true
culture_settlement_occupation_options_tooltip_750755312	Search Ruins||You will be presented with a puzzle to solve; you will be rewarded if you successfully decipher it.	true
culture_settlement_occupation_options_tooltip_641469026	Do Nothing||Leave the settlement as it stands.	true
culture_settlement_occupation_options_tooltip_434162375	Do Nothing||Leave the settlement as it stands.	true
culture_settlement_occupation_options_tooltip_302336655	Do Nothing||Leave the settlement as it stands.	true
culture_settlement_occupation_options_tooltip_912681004	Colonise||Settle your troops.	true
culture_settlement_occupation_options_tooltip_615256079	Establish a Pirate Cove||You do not capture the settlement but instead establish a Pirate Cove inside it. From there, you can conduct business and leech off the occupier without them being aware of your presence…	true
culture_settlement_occupation_options_tooltip_578727725	Do Nothing||Leave the settlement as it stands.	true
culture_settlement_occupation_options_tooltip_379147647	Resettle||With no regions currently under your control, you have the option to settle your army here.	true
culture_settlement_occupation_options_tooltip_459557006	Do Nothing||Leave the settlement as it stands.	true
culture_settlement_occupation_options_tooltip_330701027	Occupy||{{tr:occupation_decision_occupy}}	true
culture_settlement_occupation_options_tooltip_452664537	Sack||You do not capture the settlement but instead steal wealth and damage buildings. All captives are enslaved, [[img:icon_public_order]][[/img]]{{tr:hp_campaign_public_order_term}} is reduced, and the previous owners will like you a lot less.	true
culture_settlement_occupation_options_tooltip_358483105	Resettle||With no regions currently under your control, you have the option to settle your army here.	true
culture_settlement_occupation_options_tooltip_671289763	Sack||You do not capture the settlement but instead steal wealth and damage buildings. All captives are enslaved, [[img:icon_public_order]][[/img]]{{tr:hp_campaign_public_order_term}} is reduced, and the previous owners will like you a lot less.	true
culture_settlement_occupation_options_tooltip_502334874	Raze||All buildings are destroyed and the settlement is torched.	true
culture_settlement_occupation_options_tooltip_559770731	Raze||All buildings are destroyed and the settlement is torched.	true
culture_settlement_occupation_options_tooltip_626766733	Occupy||{{tr:occupation_decision_occupy}}	true
culture_settlement_occupation_options_tooltip_178515110	Occupy||{{tr:occupation_decision_occupy}}	true
culture_settlement_occupation_options_tooltip_286479405	Search Ruins||You will be presented with a puzzle to solve; you will be rewarded if you successfully decipher it.	true
culture_settlement_occupation_options_tooltip_826165558	Do nothing||You take no action. This settlement has already been plundered.	true
culture_settlement_occupation_options_tooltip_774382878	Resettle||With no regions currently under your control, you have the option to settle your army here.	true
culture_settlement_occupation_options_tooltip_318302077	Occupy||{{tr:occupation_decision_occupy}}	true
culture_settlement_occupation_options_tooltip_129338677	Raze||All buildings are destroyed and the settlement is torched.	true
culture_settlement_occupation_options_tooltip_620792444	Occupy||{{tr:occupation_decision_occupy}}	true
culture_settlement_occupation_options_tooltip_544256519	Loot & Occupy||You gain wealth from looting, but buildings in the settlement are damaged. All captives are enslaved, [[img:icon_public_order]][[/img]]{{tr:hp_campaign_public_order_term}} is greatly reduced, and your diplomatic relations with the previous owner also suffer greatly.	true
culture_settlement_occupation_options_tooltip_537430777	Resettle||With no regions currently under your control, you have the option to settle your army here.	true
culture_settlement_occupation_options_tooltip_694335004	Colonise||Settle your troops.	true
culture_settlement_occupation_options_tooltip_852431760	Occupy||{{tr:occupation_decision_occupy}}	true
culture_settlement_occupation_options_tooltip_843652244	Do Nothing||Leave the settlement as it stands.	true
culture_settlement_occupation_options_tooltip_847752454	Occupy||{{tr:occupation_decision_occupy}}	true
culture_settlement_occupation_options_tooltip_968262900	Resettle||With no regions currently under your control, you have the option to settle your army here.	true
culture_settlement_occupation_options_tooltip_184015622	Sack||You do not capture the settlement but instead steal wealth and damage buildings. All captives are enslaved, [[img:icon_public_order]][[/img]]{{tr:hp_campaign_public_order_term}} is reduced, and the previous owners will like you a lot less.	true
culture_settlement_occupation_options_tooltip_897029428	Do Nothing||Leave the settlement as it stands.	true
culture_settlement_occupation_options_tooltip_461533876	Do Nothing||Leave the settlement as it stands.	true
culture_settlement_occupation_options_tooltip_468264503	Search Ruins||You will be presented with a puzzle to solve; you will be rewarded if you successfully decipher it.	true
culture_settlement_occupation_options_tooltip_946502278	Occupy||{{tr:occupation_decision_occupy}}	true
culture_settlement_occupation_options_tooltip_344245101	Loot & Occupy||You gain wealth from looting, but buildings in the settlement are damaged. All captives are enslaved, [[img:icon_public_order]][[/img]]{{tr:hp_campaign_public_order_term}} is greatly reduced, and your diplomatic relations with the previous owner also suffer greatly.	true
culture_settlement_occupation_options_tooltip_565241207	Colonise||Settle your troops.	true
culture_settlement_occupation_options_tooltip_910198734	Loot & Occupy||You gain wealth from looting, but buildings in the settlement are damaged. All captives are enslaved, [[img:icon_public_order]][[/img]]{{tr:hp_campaign_public_order_term}} is greatly reduced, and your diplomatic relations with the previous owner also suffer greatly.	true
culture_settlement_occupation_options_tooltip_149279903	Raze||All buildings are destroyed and the settlement is torched.	true
culture_settlement_occupation_options_tooltip_683105133	Occupy||{{tr:occupation_decision_occupy}}	true
culture_settlement_occupation_options_tooltip_477184507	Raze||All buildings are destroyed and the settlement is torched.	true
culture_settlement_occupation_options_tooltip_485094116	Resettle||With no regions currently under your control, you have the option to settle your army here.	true
culture_settlement_occupation_options_tooltip_375938188	Occupy||{{tr:occupation_decision_occupy}}	true
culture_settlement_occupation_options_tooltip_917506445	Colonise||Settle your troops.	true
culture_settlement_occupation_options_tooltip_649937788	Raze||All buildings are destroyed and the settlement is torched.	true
culture_settlement_occupation_options_tooltip_292009110	Loot & Occupy||You gain wealth from looting, but buildings in the settlement are damaged. All captives are enslaved, [[img:icon_public_order]][[/img]]{{tr:hp_campaign_public_order_term}} is greatly reduced, and your diplomatic relations with the previous owner also suffer greatly.	true
culture_settlement_occupation_options_tooltip_347600671	Occupy||You occupy this settlement.	true
culture_settlement_occupation_options_tooltip_130461954	Search Ruins||You will be presented with a puzzle to solve; you will be rewarded if you successfully decipher it.	true
culture_settlement_occupation_options_tooltip_929122508	Do Nothing||Leave the settlement as it stands.	true
culture_settlement_occupation_options_tooltip_362128600	Occupy||{{tr:occupation_decision_occupy}}	true
culture_settlement_occupation_options_tooltip_724597048	Loot & Occupy||You gain wealth from looting, but buildings in the settlement are damaged. All captives are enslaved, [[img:icon_public_order]][[/img]]{{tr:hp_campaign_public_order_term}} is greatly reduced, and your diplomatic relations with the previous owner also suffer greatly.	true
culture_settlement_occupation_options_tooltip_169263530	Colonise||Settle your troops.	true
culture_settlement_occupation_options_tooltip_384378120	Raze||All buildings are destroyed and the settlement is torched.	true
culture_settlement_occupation_options_tooltip_457649475	Raze||All buildings are destroyed and the settlement is torched.	true
culture_settlement_occupation_options_tooltip_957672264	Colonise||Settle your troops.	true
culture_settlement_occupation_options_tooltip_197088902	Colonise||Settle your troops.	true
culture_settlement_occupation_options_tooltip_310304338	Do Nothing||Leave the settlement as it stands.	true
culture_settlement_occupation_options_tooltip_111999490	Colonise||Settle your troops.	true
culture_settlement_occupation_options_tooltip_189861589	Search Ruins||You will be presented with a puzzle to solve; you will be rewarded if you successfully decipher it.	true
culture_settlement_occupation_options_tooltip_962958990	Do Nothing||Leave the settlement as it stands.	true
culture_settlement_occupation_options_tooltip_331678166	Occupy||{{tr:occupation_decision_occupy}}	true
culture_settlement_occupation_options_tooltip_770811584	Loot & Occupy||You gain wealth from looting, but buildings in the settlement are damaged. All captives are enslaved, [[img:icon_public_order]][[/img]]{{tr:hp_campaign_public_order_term}} is greatly reduced, and your diplomatic relations with the previous owner also suffer greatly.	true
culture_settlement_occupation_options_tooltip_475235224	Sack||You do not capture the settlement but instead steal wealth and damage buildings. All captives are enslaved, [[img:icon_public_order]][[/img]]{{tr:hp_campaign_public_order_term}} is reduced, and the previous owners will like you a lot less.	true
culture_settlement_occupation_options_tooltip_964082100	Resettle||With no regions currently under your control you have the option to settle your army here.	true
culture_settlement_occupation_options_tooltip_398360932	Colonise||Settle your troops.	true
culture_settlement_occupation_options_tooltip_488642667	Sack||You do not capture the settlement but instead steal wealth and damage buildings. All captives are enslaved, [[img:icon_public_order]][[/img]]{{tr:hp_campaign_public_order_term}} is reduced, and the previous owners will like you a lot less.	true
culture_settlement_occupation_options_tooltip_798377337	Do Nothing||Leave the settlement as it stands.	true
culture_settlement_occupation_options_tooltip_771572555	Colonise||Settle your troops.	true
culture_settlement_occupation_options_tooltip_1027	Occupy||{{tr:occupation_decision_occupy}}	true
culture_settlement_occupation_options_tooltip_1024	Loot & Occupy||You gain wealth from looting, but buildings in the settlement are damaged. All captives are enslaved, [[img:icon_public_order]][[/img]]{{tr:hp_campaign_public_order_term}} is greatly reduced, and your diplomatic relations with the previous owner also suffer greatly.	true
culture_settlement_occupation_options_tooltip_1023	Do Nothing||Leave the settlement as it stands.	true
culture_settlement_occupation_options_tooltip_1223	Search Ruins||You will be presented with a puzzle to solve; you will be rewarded if you successfully decipher it.	true
culture_settlement_occupation_options_tooltip_1129	Colonise||Settle your troops.	true
culture_settlement_occupation_options_tooltip_1137	Loot & Occupy||You gain wealth from looting, but buildings in the settlement are damaged. All captives are enslaved, [[img:icon_public_order]][[/img]]{{tr:hp_campaign_public_order_term}} is greatly reduced, and your diplomatic relations with the previous owner also suffer greatly.	true
culture_settlement_occupation_options_tooltip_1237	Search Ruins||You will be presented with a puzzle to solve; you will be rewarded if you successfully decipher it.	true
culture_settlement_occupation_options_tooltip_1036	Sack||You do not capture the settlement but instead steal wealth and damage buildings. All captives are enslaved, [[img:icon_public_order]][[/img]]{{tr:hp_campaign_public_order_term}} is reduced, and the previous owners will like you a lot less.	true
culture_settlement_occupation_options_tooltip_1034	Resettle||With no regions currently under your control, you have the option to settle your army here.	true
culture_settlement_occupation_options_tooltip_1134	Do Nothing||Leave the settlement as it stands.	true
culture_settlement_occupation_options_tooltip_1032	Raze||All buildings are destroyed and the settlement is torched.	true
culture_settlement_occupation_options_tooltip_1232	Search Ruins||You will be presented with a puzzle to solve; you will be rewarded if you successfully decipher it.	true
culture_settlement_occupation_options_tooltip_1239	Search Ruins||You will be presented with a puzzle to solve; you will be rewarded if you successfully decipher it.	true
culture_settlement_occupation_options_tooltip_1206	Search Ruins||You will be presented with a puzzle to solve, rewarding you if successfully deciphered.	true
culture_settlement_occupation_options_tooltip_1103	Occupy||{{tr:occupation_decision_occupy}}	true
culture_settlement_occupation_options_tooltip_1201	Search Ruins||You will be presented with a puzzle to solve, rewarding you if successfully deciphered.	true
culture_settlement_occupation_options_tooltip_1115	Resettle||With no regions currently under your control, you have the option to settle your army here.	true
culture_settlement_occupation_options_tooltip_1214	Search Ruins||You will be presented with a puzzle to solve; you will be rewarded if you successfully decipher it.	true
culture_settlement_occupation_options_tooltip_1212	Search Ruins||You will be presented with a puzzle to solve; you will be rewarded if you successfully decipher it.	true
culture_settlement_occupation_options_tooltip_1110	Raze||All buildings are destroyed and the settlement is torched.	true
culture_settlement_occupation_options_tooltip_1018	Colonise||Settle your troops.	true
culture_settlement_occupation_options_tooltip_1118	Sack||You do not capture the settlement but instead steal wealth and damage buildings. All captives are enslaved, [[img:icon_public_order]][[/img]]{{tr:hp_campaign_public_order_term}} is reduced, and the previous owners will like you a lot less.	true
culture_settlement_occupation_options_tooltip_1063	Occupy||{{tr:occupation_decision_occupy}}	true
culture_settlement_occupation_options_tooltip_1161	Sack||You do not capture the settlement but instead steal wealth and damage buildings. All captives are enslaved, [[img:icon_public_order]][[/img]]{{tr:hp_campaign_public_order_term}} is reduced, and the previous owners will like you a lot less.	true
culture_settlement_occupation_options_tooltip_1176	Search Ruins||You will be presented with a puzzle to solve, rewarding you if successfully deciphered.	true
culture_settlement_occupation_options_tooltip_1172	Loot & Raze||You do not capture the settlement but instead steal the wealth and torch the place.	true
culture_settlement_occupation_options_tooltip_1071	Resettle||With no regions currently under your control, you have the option to settle your army here.	true
culture_settlement_occupation_options_tooltip_1070	Raze||All buildings are destroyed and the settlement is torched.	true
culture_settlement_occupation_options_tooltip_1078	Sack||You do not capture the settlement but instead steal wealth and damage buildings. All captives are enslaved, [[img:icon_public_order]][[/img]]{{tr:hp_campaign_public_order_term}} is reduced, and the previous owners will like you a lot less.	true
culture_settlement_occupation_options_tooltip_1043	Colonise||Settle your troops.	true
culture_settlement_occupation_options_tooltip_1240	Search Ruins||You will be presented with a puzzle to solve; you will be rewarded if you successfully decipher it.	true
culture_settlement_occupation_options_tooltip_1249	Search Ruins||You will be presented with a puzzle to solve; you will be rewarded if you successfully decipher it.	true
culture_settlement_occupation_options_tooltip_1148	Raze||All buildings are destroyed and the settlement is torched.	true
culture_settlement_occupation_options_tooltip_1156	Resettle||With no regions currently under your control, you have the option to settle your army here.	true
culture_settlement_occupation_options_tooltip_1051	Do Nothing||Leave the settlement as it stands.	true
culture_settlement_occupation_options_tooltip_1058	Loot & Occupy||You gain wealth from looting, but buildings in the settlement are damaged. All captives are enslaved, [[img:icon_public_order]][[/img]]{{tr:hp_campaign_public_order_term}} is greatly reduced, and your diplomatic relations with the previous owner also suffer greatly.	true
culture_settlement_occupation_options_tooltip_1185	Search Ruins||You will be presented with a puzzle to solve, rewarding you if successfully deciphered.	true
culture_settlement_occupation_options_tooltip_1083	Colonise||Settle your troops.	true
culture_settlement_occupation_options_tooltip_1181	Search Ruins||You will be presented with a puzzle to solve, rewarding you if successfully deciphered.	true
culture_settlement_occupation_options_tooltip_1096	Loot & Occupy||You gain wealth from looting, but buildings in the settlement are damaged. All captives are enslaved, [[img:icon_public_order]][[/img]]{{tr:hp_campaign_public_order_term}} is greatly reduced, and your diplomatic relations with the previous owner also suffer greatly.	true
culture_settlement_occupation_options_tooltip_1093	Do Nothing||Leave the settlement as it stands.	true
culture_settlement_occupation_options_tooltip_1193	Search Ruins||You will be presented with a puzzle to solve, rewarding you if successfully deciphered.	true
culture_settlement_occupation_options_tooltip_1199	Search Ruins||You will be presented with a puzzle to solve, rewarding you if successfully deciphered.	true
