ancillaries_required_skills_tables	1
ancillary	required_skill	required_skill_level
wh2_dlc09_anc_mount_tmb_arkhan_skeletal_steed	wh2_dlc09_skill_tmb_lord_unique_arkhan_skeletal_steed	1
wh2_dlc09_anc_mount_tmb_arkhan_skeleton_chariot	wh2_dlc09_skill_tmb_lord_unique_arkhan_skeleton_chariot	1
wh2_dlc09_anc_mount_tmb_khalida_necroserpent	wh2_dlc09_skill_tmb_lord_unique_khalida_necroserpent	1
wh2_dlc09_anc_mount_tmb_khalida_skeleton_chariot	wh2_dlc09_skill_tmb_lord_unique_khalida_skeleton_chariot	1
wh2_dlc09_anc_mount_tmb_khatep_skeletal_steed	wh2_dlc09_skill_tmb_lord_unique_khatep_skeletal_steed	1
wh2_dlc09_anc_mount_tmb_khatep_skeleton_chariot	wh2_dlc09_skill_tmb_lord_unique_khatep_skeleton_chariot	1
wh2_dlc09_anc_mount_tmb_liche_priest_death_skeletal_steed	wh2_dlc09_skill_tmb_wizard_unique_liche_priest_death_skeletal_steed	1
wh2_dlc09_anc_mount_tmb_liche_priest_light_skeletal_steed	wh2_dlc09_skill_tmb_wizard_unique_liche_priest_light_skeletal_steed	1
wh2_dlc09_anc_mount_tmb_liche_priest_nehekhara_skeletal_steed	wh2_dlc09_skill_tmb_wizard_unique_liche_priest_nehekhara_skeletal_steed	1
wh2_dlc09_anc_mount_tmb_liche_priest_shadow_skeletal_steed	wh2_dlc09_skill_tmb_wizard_unique_liche_priest_shadow_skeletal_steed	1
wh2_dlc09_anc_mount_tmb_necrotect_skeleton_chariot	wh2_dlc09_skill_tmb_engineer_unique_necrotect_skeleton_chariot	1
wh2_dlc09_anc_mount_tmb_settra_chariot_of_the_gods	wh2_dlc09_skill_tmb_lord_unique_settra_chariot_of_the_gods	1
wh2_dlc09_anc_mount_tmb_settra_khemrian_warsphinx	wh2_dlc09_skill_tmb_lord_unique_settra_khemrian_warsphinx	1
wh2_dlc09_anc_mount_tmb_settra_skeletal_steed	wh2_dlc09_skill_tmb_lord_unique_settra_skeletal_steed	1
wh2_dlc09_anc_mount_tmb_tomb_king_khemrian_warsphinx	wh2_dlc09_skill_tmb_lord_unique_tomb_king_khemrian_warsphinx	1
wh2_dlc09_anc_mount_tmb_tomb_king_skeletal_steed	wh2_dlc09_skill_tmb_lord_unique_tomb_king_skeletal_steed	1
wh2_dlc09_anc_mount_tmb_tomb_king_skeleton_chariot	wh2_dlc09_skill_tmb_lord_unique_tomb_king_skeleton_chariot	1
wh2_dlc09_anc_mount_tmb_tomb_prince_skeletal_steed	wh2_dlc09_skill_tmb_champion_unique_tomb_prince_skeletal_steed	1
wh2_dlc09_anc_mount_tmb_tomb_prince_skeleton_chariot	wh2_dlc09_skill_tmb_champion_unique_tomb_prince_skeleton_chariot	1
wh2_dlc10_anc_mount_def_crone_cauldron_of_blood	wh2_dlc10_skill_def_crone_mount_cauldron_of_blood	1
wh2_dlc10_anc_mount_def_crone_dark_steed	wh2_dlc10_skill_def_crone_mount_dark_steed	1
wh2_dlc10_anc_mount_def_crone_manticore	wh2_dlc10_skill_def_crone_mount_manticore	1
wh2_dlc10_anc_mount_def_sorceress_beasts_cold_one	wh2_dlc10_skill_def_sorceress_beasts_mount_cold_one	1
wh2_dlc10_anc_mount_def_sorceress_beasts_dark_pegasus	wh2_dlc10_skill_def_sorceress_beasts_mount_dark_pegasus	1
wh2_dlc10_anc_mount_def_sorceress_beasts_dark_steed	wh2_dlc10_skill_def_sorceress_beasts_mount_dark_steed	1
wh2_dlc10_anc_mount_def_sorceress_death_cold_one	wh2_dlc10_skill_def_sorceress_death_mount_cold_one	1
wh2_dlc10_anc_mount_def_sorceress_death_dark_pegasus	wh2_dlc10_skill_def_sorceress_death_mount_dark_pegasus	1
wh2_dlc10_anc_mount_def_sorceress_death_dark_steed	wh2_dlc10_skill_def_sorceress_death_mount_dark_steed	1
wh2_dlc10_anc_mount_def_supreme_sorceress_beasts_black_dragon	wh2_dlc10_skill_def_supreme_sorceress_beasts_mount_black_dragon	1
wh2_dlc10_anc_mount_def_supreme_sorceress_beasts_cold_one	wh2_dlc10_skill_def_supreme_sorceress_beasts_mount_cold_one	1
wh2_dlc10_anc_mount_def_supreme_sorceress_beasts_dark_pegasus	wh2_dlc10_skill_def_supreme_sorceress_beasts_mount_dark_pegasus	1
wh2_dlc10_anc_mount_def_supreme_sorceress_beasts_dark_steed	wh2_dlc10_skill_def_supreme_sorceress_beasts_mount_dark_steed	1
wh2_dlc10_anc_mount_def_supreme_sorceress_beasts_manticore	wh2_dlc10_skill_def_supreme_sorceress_beasts_mount_manticore	1
wh2_dlc10_anc_mount_def_supreme_sorceress_dark_black_dragon	wh2_dlc10_skill_def_supreme_sorceress_dark_mount_black_dragon	1
wh2_dlc10_anc_mount_def_supreme_sorceress_dark_cold_one	wh2_dlc10_skill_def_supreme_sorceress_dark_mount_cold_one	1
wh2_dlc10_anc_mount_def_supreme_sorceress_dark_dark_pegasus	wh2_dlc10_skill_def_supreme_sorceress_dark_mount_dark_pegasus	1
wh2_dlc10_anc_mount_def_supreme_sorceress_dark_dark_steed	wh2_dlc10_skill_def_supreme_sorceress_dark_mount_dark_steed	1
wh2_dlc10_anc_mount_def_supreme_sorceress_dark_manticore	wh2_dlc10_skill_def_supreme_sorceress_dark_mount_manticore	1
wh2_dlc10_anc_mount_def_supreme_sorceress_death_black_dragon	wh2_dlc10_skill_def_supreme_sorceress_death_mount_black_dragon	1
wh2_dlc10_anc_mount_def_supreme_sorceress_death_cold_one	wh2_dlc10_skill_def_supreme_sorceress_death_mount_cold_one	1
wh2_dlc10_anc_mount_def_supreme_sorceress_death_dark_pegasus	wh2_dlc10_skill_def_supreme_sorceress_death_mount_dark_pegasus	1
wh2_dlc10_anc_mount_def_supreme_sorceress_death_dark_steed	wh2_dlc10_skill_def_supreme_sorceress_death_mount_dark_steed	1
wh2_dlc10_anc_mount_def_supreme_sorceress_death_manticore	wh2_dlc10_skill_def_supreme_sorceress_death_mount_manticore	1
wh2_dlc10_anc_mount_def_supreme_sorceress_fire_black_dragon	wh2_dlc10_skill_def_supreme_sorceress_fire_mount_black_dragon	1
wh2_dlc10_anc_mount_def_supreme_sorceress_fire_cold_one	wh2_dlc10_skill_def_supreme_sorceress_fire_mount_cold_one	1
wh2_dlc10_anc_mount_def_supreme_sorceress_fire_dark_pegasus	wh2_dlc10_skill_def_supreme_sorceress_fire_mount_dark_pegasus	1
wh2_dlc10_anc_mount_def_supreme_sorceress_fire_dark_steed	wh2_dlc10_skill_def_supreme_sorceress_fire_mount_dark_steed	1
wh2_dlc10_anc_mount_def_supreme_sorceress_fire_manticore	wh2_dlc10_skill_def_supreme_sorceress_fire_mount_manticore	1
wh2_dlc10_anc_mount_def_supreme_sorceress_shadow_black_dragon	wh2_dlc10_skill_def_supreme_sorceress_shadow_mount_black_dragon	1
wh2_dlc10_anc_mount_def_supreme_sorceress_shadow_cold_one	wh2_dlc10_skill_def_supreme_sorceress_shadow_mount_cold_one	1
wh2_dlc10_anc_mount_def_supreme_sorceress_shadow_dark_pegasus	wh2_dlc10_skill_def_supreme_sorceress_shadow_mount_dark_pegasus	1
wh2_dlc10_anc_mount_def_supreme_sorceress_shadow_dark_steed	wh2_dlc10_skill_def_supreme_sorceress_shadow_mount_dark_steed	1
wh2_dlc10_anc_mount_def_supreme_sorceress_shadow_manticore	wh2_dlc10_skill_def_supreme_sorceress_shadow_mount_manticore	1
wh2_dlc10_anc_mount_hef_alarielle_barded_ithilmar_steed	wh2_dlc10_skill_hef_alarielle_mount_barded_ithilmar_steed	1
wh2_dlc10_anc_mount_hef_alarielle_elven_steed	wh2_dlc10_skill_hef_alarielle_mount_elven_steed	1
wh2_dlc10_anc_mount_hef_alarielle_great_eagle	wh2_dlc10_skill_hef_alarielle_mount_great_eagle	1
wh2_dlc10_anc_mount_hef_handmaiden_barded_ithilmar_steed	wh2_dlc10_skill_hef_handmaiden_barded_ithilmar_steed	1
wh2_dlc10_anc_mount_hef_handmaiden_elven_steed	wh2_dlc10_skill_hef_handmaiden_elven_steed	1
wh2_dlc10_anc_mount_hef_mage_heavens_elven_steed	wh2_dlc10_skill_hef_mage_heavens_mount_elven_steed	1
wh2_dlc10_anc_mount_hef_mage_heavens_ithilmar_chariot	wh2_dlc10_skill_hef_mage_heavens_mount_ithilmar_chariot	1
wh2_dlc10_anc_mount_hef_mage_shadows_elven_steed	wh2_dlc10_skill_hef_mage_shadows_mount_elven_steed	1
wh2_dlc10_anc_mount_hef_mage_shadows_ithilmar_chariot	wh2_dlc10_skill_hef_mage_shadows_mount_ithilmar_chariot	1
wh2_dlc11_anc_mount_brt_damned_paladin_barded_warhorse	wh2_dlc11_skill_brt_champion_unique_paladin_damned_barded_warhorse	1
wh2_dlc11_anc_mount_cst_admiral_tech_01_rotting_promethean	wh2_dlc11_skill_cst_mount_admiral_tech_01	1
wh2_dlc11_anc_mount_cst_admiral_tech_02_rotting_promethean	wh2_dlc11_skill_cst_mount_admiral_tech_02	1
wh2_dlc11_anc_mount_cst_admiral_tech_03_rotting_promethean	wh2_dlc11_skill_cst_mount_admiral_tech_03	1
wh2_dlc11_anc_mount_cst_admiral_tech_04_rotting_promethean	wh2_dlc11_skill_cst_mount_admiral_tech_04	1
wh2_dlc11_anc_mount_cst_aranessa_rotting_promethean	wh2_dlc11_skill_cst_mount_aranessa	1
wh2_dlc11_anc_mount_cst_count_noctilus_necrofex_colossus	wh2_dlc11_skill_cst_mount_noctilus	1
wh2_dlc11_anc_mount_cst_cylostra_rotting_leviathon	wh2_dlc11_skill_cst_mount_cylostra	1
wh2_dlc11_anc_mount_cst_fleet_admiral_death_fem_rotting_promethean	wh2_dlc11_skill_cst_mount_admiral_fem_death	1
wh2_dlc11_anc_mount_cst_fleet_admiral_death_rotting_promethean	wh2_dlc11_skill_cst_mount_admiral_death	1
wh2_dlc11_anc_mount_cst_fleet_admiral_deep_fem_rotting_promethean	wh2_dlc11_skill_cst_mount_admiral_fem_deep	1
wh2_dlc11_anc_mount_cst_fleet_admiral_deep_rotting_promethean	wh2_dlc11_skill_cst_mount_admiral_deep	1
wh2_dlc11_anc_mount_cst_fleet_admiral_fem_vampires_rotting_promethean	wh2_dlc11_skill_cst_mount_admiral_fem	1
wh2_dlc11_anc_mount_cst_fleet_admiral_vampires_rotting_promethean	wh2_dlc11_skill_cst_mount_admiral	1
wh2_dlc11_anc_mount_cst_fleet_captain_death_rotting_promethean	wh2_dlc11_skill_cst_mount_fleet_captain_death	1
wh2_dlc11_anc_mount_cst_fleet_captain_deep_rotting_promethean	wh2_dlc11_skill_cst_mount_fleet_captain_deep	1
wh2_dlc11_anc_mount_cst_fleet_captain_vampires_rotting_promethean	wh2_dlc11_skill_cst_mount_fleet_captain	1
wh2_dlc11_anc_mount_cst_gunnery_wight_rotting_promethean	wh2_dlc11_skill_cst_mount_gunnery_wight	1
wh2_dlc11_anc_mount_cst_luthor_harkon_terrorgheist	wh2_dlc11_skill_cst_mount_harkon	1
wh2_dlc11_anc_mount_def_lokhir_fellheart_black_dragon	wh2_dlc11_skill_cst_lokhir_mount	1
wh2_dlc11_anc_mount_emp_boris_todbringer_imperial_griffon	wh2_dlc11_skill_emp_boris_unique_imperial_griffon	1
wh2_dlc11_anc_mount_emp_boris_todbringer_imperial_pegasus	wh2_dlc11_skill_emp_boris_unique_imperial_pegasus	1
wh2_dlc11_anc_mount_vmp_bloodline_blood_dragon_barded_nightmare	wh2_dlc11_skill_vmp_bloodline_blood_dragon_unique_barded_nightmare	1
wh2_dlc11_anc_mount_vmp_bloodline_blood_dragon_hellsteed	wh2_dlc11_skill_vmp_bloodline_blood_dragon_unique_hellsteed	1
wh2_dlc11_anc_mount_vmp_bloodline_blood_dragon_zombie_dragon	wh2_dlc11_skill_vmp_bloodline_blood_dragon_unique_zombie_dragon	1
wh2_dlc11_anc_mount_vmp_bloodline_lahmian_barded_nightmare	wh2_dlc11_skill_vmp_bloodline_lahmian_unique_barded_nightmare	1
wh2_dlc11_anc_mount_vmp_bloodline_lahmian_hellsteed	wh2_dlc11_skill_vmp_bloodline_lahmian_unique_hellsteed	1
wh2_dlc11_anc_mount_vmp_bloodline_lahmian_zombie_dragon	wh2_dlc11_skill_vmp_bloodline_lahmian_unique_zombie_dragon	1
wh2_dlc11_anc_mount_vmp_bloodline_necrarch_barded_nightmare	wh2_dlc11_skill_vmp_bloodline_necrarch_unique_barded_nightmare	1
wh2_dlc11_anc_mount_vmp_bloodline_necrarch_hellsteed	wh2_dlc11_skill_vmp_bloodline_necrarch_unique_hellsteed	1
wh2_dlc11_anc_mount_vmp_bloodline_necrarch_zombie_dragon	wh2_dlc11_skill_vmp_bloodline_necrarch_unique_zombie_dragon	1
wh2_dlc11_anc_mount_vmp_bloodline_strigoi_terrorgheist	wh2_dlc11_skill_vmp_bloodline_strigoi_unique_terrorgheist	1
wh2_dlc11_anc_mount_vmp_bloodline_von_carstein_barded_nightmare	wh2_dlc11_skill_vmp_bloodline_von_carstein_unique_barded_nightmare	1
wh2_dlc11_anc_mount_vmp_bloodline_von_carstein_hellsteed	wh2_dlc11_skill_vmp_bloodline_von_carstein_unique_hellsteed	1
wh2_dlc11_anc_mount_vmp_bloodline_von_carstein_zombie_dragon	wh2_dlc11_skill_vmp_bloodline_von_carstein_unique_zombie_dragon	1
wh2_dlc11_anc_mount_vmp_kemmler_barded_nightmare	wh2_dlc11_skill_vmp_lord_unique_kemmler_barded_nightmare	1
wh2_dlc12_anc_mount_lzd_red_crested_skink_chief_ancient_stegadon	wh2_dlc12_skill_lzd_red_crested_skink_chief_mount_ancient_stegadon	1
wh2_dlc12_anc_mount_lzd_red_crested_skink_chief_horned_one	wh2_dlc12_skill_lzd_red_crested_skink_chief_mount_horned_one	1
wh2_dlc12_anc_mount_lzd_red_crested_skink_chief_ripperdactyl	wh2_dlc12_skill_lzd_red_crested_skink_chief_mount_ripperdactyl	1
wh2_dlc12_anc_mount_lzd_skink_priest_beasts_ancient_stegadon_engine_gods	wh2_dlc12_skill_lzd_skink_priest_beasts_mount_ancient_stegadon_engine_gods	1
wh2_dlc12_anc_mount_lzd_skink_priest_heavens_ancient_stegadon_engine_gods	wh2_dlc12_skill_lzd_skink_priest_heavens_mount_ancient_stegadon_engine_gods	1
wh2_dlc12_anc_mount_lzd_tehenhauin_ancient_stegadon_engine_gods	wh2_dlc12_skill_lzd_tehenhauin_mount_ancient_stegadon_engine_gods	1
wh2_dlc12_anc_mount_lzd_tehenhauin_horned_one	wh2_dlc12_skill_lzd_tehenhauin_mount_horned_one	1
wh2_dlc12_anc_mount_lzd_tehenhauin_ripperdactyl	wh2_dlc12_skill_lzd_tehenhauin_mount_ripperdactyl	1
wh2_dlc12_anc_mount_lzd_tlaqua_skink_chief_terradon	wh2_dlc12_skill_lzd_tlaqua_mount_skink_chief_terradon	1
wh2_dlc12_anc_mount_lzd_tlaqua_skink_priest_beasts_ancient_stegadon_engine_gods	wh2_dlc12_skill_lzd_tlaqua_skink_priest_beasts_mount_ancient_stegadon_engine_gods	1
wh2_dlc12_anc_mount_lzd_tlaqua_skink_priest_beasts_terradon	wh2_dlc12_skill_lzd_tlaqua_mount_skink_priest_beasts_terradon	1
wh2_dlc12_anc_mount_lzd_tlaqua_skink_priest_heavens_ancient_stegadon_engine_gods	wh2_dlc12_skill_lzd_tlaqua_skink_priest_heavens_mount_ancient_stegadon_engine_gods	1
wh2_dlc12_anc_mount_lzd_tlaqua_skink_priest_heavens_terradon	wh2_dlc12_skill_lzd_tlaqua_mount_skink_priest_heavens_terradon	1
wh2_dlc12_anc_mount_skv_ikit_claw_doom_flayer	wh2_dlc12_skill_skv_ikit_mount_doom_flayer	1
wh2_dlc12_anc_mount_skv_ikit_claw_doomwheel	wh2_dlc12_skill_skv_ikit_mount_doomwheel	1
wh2_dlc12_anc_mount_skv_warlock_master_doom_flayer	wh2_dlc12_skill_skv_warlock_master_mount_doom_flayer	1
wh2_dlc12_anc_mount_skv_warlock_master_doomwheel	wh2_dlc12_skill_skv_warlock_master_mount_doomwheel	1
wh2_main_anc_mount_def_death_hag_cauldron_of_blood	wh2_main_skill_def_death_hag_mount_cauldron_of_blood	1
wh2_main_anc_mount_def_dreadlord_black_dragon	wh2_main_skill_def_dreadlord_mount_black_dragon	1
wh2_main_anc_mount_def_dreadlord_cold_one	wh2_main_skill_def_dreadlord_mount_cold_one	1
wh2_main_anc_mount_def_dreadlord_dark_pegasus	wh2_main_skill_def_dreadlord_mount_dark_pegasus	1
wh2_main_anc_mount_def_dreadlord_dark_steed	wh2_main_skill_def_dreadlord_mount_dark_steed	1
wh2_main_anc_mount_def_dreadlord_fem_black_dragon	wh2_main_skill_def_dreadlord_fem_mount_black_dragon	1
wh2_main_anc_mount_def_dreadlord_fem_cold_one	wh2_main_skill_def_dreadlord_fem_mount_cold_one	1
wh2_main_anc_mount_def_dreadlord_fem_dark_pegasus	wh2_main_skill_def_dreadlord_fem_mount_dark_pegasus	1
wh2_main_anc_mount_def_dreadlord_fem_dark_steed	wh2_main_skill_def_dreadlord_fem_mount_dark_steed	1
wh2_main_anc_mount_def_malekith_cold_one_chariot	wh2_main_skill_def_malekith_mount_cold_one_chariot	1
wh2_main_anc_mount_def_malekith_cold_one	wh2_main_skill_def_malekith_mount_cold_one	1
wh2_main_anc_mount_def_malekith_seraphon	wh2_main_skill_def_malekith_mount_seraphon	1
wh2_main_anc_mount_def_morathi_sulephet	wh2_main_skill_def_morathi_mount_sulephet	1
wh2_main_anc_mount_def_sorceress_dark_cold_one	wh2_main_skill_def_sorceress_dark_mount_cold_one	1
wh2_main_anc_mount_def_sorceress_dark_dark_pegasus	wh2_main_skill_def_sorceress_dark_mount_dark_pegasus	1
wh2_main_anc_mount_def_sorceress_dark_dark_steed	wh2_main_skill_def_sorceress_dark_mount_dark_steed	1
wh2_main_anc_mount_def_sorceress_fire_cold_one	wh2_main_skill_def_sorceress_fire_mount_cold_one	1
wh2_main_anc_mount_def_sorceress_fire_dark_pegasus	wh2_main_skill_def_sorceress_fire_mount_dark_pegasus	1
wh2_main_anc_mount_def_sorceress_fire_dark_steed	wh2_main_skill_def_sorceress_fire_mount_dark_steed	1
wh2_main_anc_mount_def_sorceress_shadow_cold_one	wh2_main_skill_def_sorceress_shadow_mount_cold_one	1
wh2_main_anc_mount_def_sorceress_shadow_dark_pegasus	wh2_main_skill_def_sorceress_shadow_mount_dark_pegasus	1
wh2_main_anc_mount_def_sorceress_shadow_dark_steed	wh2_main_skill_def_sorceress_shadow_mount_dark_steed	1
wh2_main_anc_mount_hef_alastair_great_eagle	wh2_main_skill_hef_prince_alastar_mount_great_eagle	1
wh2_main_anc_mount_hef_alastair_star_dragon	wh2_main_skill_hef_prince_alastar_mount_star_dragon	1
wh2_main_anc_mount_hef_alastair_sun_dragon	wh2_main_skill_hef_prince_alastar_mount_sun_dragon	1
wh2_main_anc_mount_hef_mage_high_elven_steed	wh2_main_skill_hef_mage_high_mount_elven_steed	1
wh2_main_anc_mount_hef_mage_high_ithilmar_chariot	wh2_main_skill_hef_mage_high_mount_ithilmar_chariot	1
wh2_main_anc_mount_hef_mage_life_elven_steed	wh2_main_skill_hef_mage_life_mount_elven_steed	1
wh2_main_anc_mount_hef_mage_life_ithilmar_chariot	wh2_main_skill_hef_mage_life_mount_ithilmar_chariot	1
wh2_main_anc_mount_hef_mage_light_elven_steed	wh2_main_skill_hef_mage_light_mount_elven_steed	1
wh2_main_anc_mount_hef_mage_light_ithilmar_chariot	wh2_main_skill_hef_mage_light_mount_ithilmar_chariot	1
wh2_main_anc_mount_hef_noble_barded_ithilmar_steed	wh2_main_skill_hef_noble_barded_ithilmar_steed	1
wh2_main_anc_mount_hef_noble_eagle	wh2_main_skill_hef_noble_great_eagle	1
wh2_main_anc_mount_hef_noble_ithilmar_chariot	wh2_main_skill_hef_noble_ithilmar_chariot	1
wh2_main_anc_mount_hef_prince_barded_ithilmar_steed	wh2_main_skill_hef_prince_mount_barded_ithilmar_steed	1
wh2_main_anc_mount_hef_prince_great_eagle	wh2_main_skill_hef_prince_mount_great_eagle	1
wh2_main_anc_mount_hef_prince_star_dragon	wh2_main_skill_hef_prince_mount_star_dragon	1
wh2_main_anc_mount_hef_prince_sun_dragon	wh2_main_skill_hef_prince_mount_sun_dragon	1
wh2_main_anc_mount_hef_princess_elven_steed	wh2_main_skill_hef_princess_mount_elven_steed	1
wh2_main_anc_mount_hef_princess_great_eagle	wh2_main_skill_hef_princess_mount_great_eagle	1
wh2_main_anc_mount_hef_princess_moon_dragon	wh2_main_skill_hef_princess_mount_moon_dragon	1
wh2_main_anc_mount_hef_princess_star_dragon	wh2_main_skill_hef_princess_mount_star_dragon	1
wh2_main_anc_mount_hef_teclis_barded_ithilmar_steed	wh2_main_skill_hef_teclis_mount_barded_ithilmar_steed	1
wh2_main_anc_mount_hef_tyrion_malhandhir	wh2_main_skill_hef_tyrion_mount_malhandhir	1
wh2_main_anc_mount_lzd_kroq_gar_cold_one	wh2_main_skill_lzd_kroq_gar_mount_1	1
wh2_main_anc_mount_lzd_kroq_gar_grymloq	wh2_main_skill_lzd_kroq_gar_mount_2	1
wh2_main_anc_mount_lzd_kroq_gar_horned_one	wh2_main_skill_lzd_kroq_gar_mount_3	1
wh2_main_anc_mount_lzd_lord_mazdamundi_zlaaq	wh2_main_skill_lzd_mazdamundi_zlaaq	1
wh2_main_anc_mount_lzd_saurus_old_blood_carnosaur	wh2_main_skill_lzd_saurus_old_blood_carnosaur	1
wh2_main_anc_mount_lzd_saurus_old_blood_cold_one	wh2_main_skill_lzd_saurus_old_blood_cold_one	1
wh2_main_anc_mount_lzd_saurus_scar_veteran_carnosaur	wh2_main_skill_lzd_saurus_scar_veteran_carnosaur	1
wh2_main_anc_mount_lzd_saurus_scar_veteran_cold_one	wh2_main_skill_lzd_saurus_scar_veteran_cold_one	1
wh2_main_anc_mount_lzd_skink_chief_ancient_stegadon	wh2_dlc12_skill_lzd_skink_chief_mount_ancient_stegadon	1
wh2_main_anc_mount_lzd_skink_chief_stegadon	wh2_main_skill_lzd_skink_chief_stegadon	1
wh2_main_anc_mount_lzd_skink_chief_terradon	wh2_main_skill_lzd_skink_chief_terradon	1
wh2_main_anc_mount_lzd_skink_priest_beasts_ancient_stegadon	wh2_dlc12_skill_lzd_skink_priest_beasts_mount_ancient_stegadon	1
wh2_main_anc_mount_lzd_skink_priest_beasts_stegadon	wh2_main_skill_lzd_skink_priest_beasts_stegadon	1
wh2_main_anc_mount_lzd_skink_priest_beasts_terradon	wh2_main_skill_lzd_skink_priest_beasts_terradon	1
wh2_main_anc_mount_lzd_skink_priest_heavens_ancient_stegadon	wh2_dlc12_skill_lzd_skink_priest_heavens_mount_ancient_stegadon	1
wh2_main_anc_mount_lzd_skink_priest_heavens_stegadon	wh2_main_skill_lzd_skink_priest_heavens_stegadon	1
wh2_main_anc_mount_lzd_skink_priest_heavens_terradon	wh2_main_skill_lzd_skink_priest_heavens_terradon	1
wh2_main_anc_mount_skv_grey_seer_plague_screaming_bell	wh2_main_skill_skv_grey_seer_plague_mount_screaming_bell	1
wh2_main_anc_mount_skv_grey_seer_ruin_screaming_bell	wh2_main_skill_skv_grey_seer_ruin_mount_screaming_bell	1
wh2_main_anc_mount_skv_plague_priest_plague_furnace	wh2_main_skill_skv_plague_priest_mount_plague_furnace	1
wh2_main_anc_mount_skv_warlord_bonebreaker	wh2_main_skill_skv_warlord_mount_1	1
wh2_pro07_anc_mount_emp_amethyst_wizard_barded_warhorse	wh2_pro07_skill_emp_wizard_unique_amethyst_wizard_barded_warhorse	1
wh2_pro07_anc_mount_emp_amethyst_wizard_imperial_pegasus	wh2_pro07_skill_emp_wizard_unique_amethyst_wizard_imperial_pegasus	1
wh2_pro07_anc_mount_emp_amethyst_wizard_warhorse	wh2_pro07_skill_emp_wizard_unique_amethyst_wizard_warhorse	1
wh_dlc01_anc_mount_chs_chaos_lord_chaos_dragon	wh_main_skill_chs_lord_unique_chaos_lord_chaos_dragon	1
wh_dlc01_anc_mount_chs_chaos_lord_manticore	wh_main_skill_chs_lord_unique_chaos_lord_manticore	1
wh_dlc01_anc_mount_chs_chaos_sorcerer_lord_death_barded_chaos_steed	wh_main_skill_chs_lord_unique_chaos_sorcerer_lord_death_barded_chaos_steed	1
wh_dlc01_anc_mount_chs_chaos_sorcerer_lord_death_chaos_steed	wh_main_skill_chs_lord_unique_chaos_sorcerer_lord_death_chaos_steed	1
wh_dlc01_anc_mount_chs_chaos_sorcerer_lord_death_dragon	wh_main_skill_chs_lord_unique_chaos_sorcerer_lord_death_chaos_dragon	1
wh_dlc01_anc_mount_chs_chaos_sorcerer_lord_death_manticore	wh_main_skill_chs_lord_unique_chaos_sorcerer_lord_death_manticore	1
wh_dlc01_anc_mount_chs_chaos_sorcerer_lord_fire_barded_chaos_steed	wh_main_skill_chs_lord_unique_chaos_sorcerer_lord_fire_barded_chaos_steed	1
wh_dlc01_anc_mount_chs_chaos_sorcerer_lord_fire_chaos_steed	wh_main_skill_chs_lord_unique_chaos_sorcerer_lord_fire_chaos_steed	1
wh_dlc01_anc_mount_chs_chaos_sorcerer_lord_fire_dragon	wh_main_skill_chs_lord_unique_chaos_sorcerer_lord_fire_chaos_dragon	1
wh_dlc01_anc_mount_chs_chaos_sorcerer_lord_fire_manticore	wh_main_skill_chs_lord_unique_chaos_sorcerer_lord_fire_manticore	1
wh_dlc01_anc_mount_chs_chaos_sorcerer_lord_metal_barded_chaos_steed	wh_main_skill_chs_lord_unique_chaos_sorcerer_lord_metal_barded_chaos_steed	1
wh_dlc01_anc_mount_chs_chaos_sorcerer_lord_metal_chaos_steed	wh_main_skill_chs_lord_unique_chaos_sorcerer_lord_metal_chaos_steed	1
wh_dlc01_anc_mount_chs_chaos_sorcerer_lord_metal_dragon	wh_main_skill_chs_lord_unique_chaos_sorcerer_lord_metal_chaos_dragon	1
wh_dlc01_anc_mount_chs_chaos_sorcerer_lord_metal_manticore	wh_main_skill_chs_lord_unique_chaos_sorcerer_lord_metal_manticore	1
wh_dlc01_anc_mount_chs_chaos_sorcerer_lord_shadow_barded_chaos_steed	wh_main_skill_chs_lord_unique_chaos_sorcerer_lord_shadow_barded_chaos_steed	1
wh_dlc01_anc_mount_chs_chaos_sorcerer_lord_shadow_chaos_steed	wh_main_skill_chs_lord_unique_chaos_sorcerer_lord_shadow_chaos_steed	1
wh_dlc01_anc_mount_chs_chaos_sorcerer_lord_shadow_dragon	wh_main_skill_chs_lord_unique_chaos_sorcerer_lord_shadow_chaos_dragon	1
wh_dlc01_anc_mount_chs_chaos_sorcerer_lord_shadow_manticore	wh_main_skill_chs_lord_unique_chaos_sorcerer_lord_shadow_manticore	1
wh_dlc01_anc_mount_chs_chaos_sorcerer_shadow_barded_chaos_steed	wh_dlc01_skill_chs_wizard_unique_chaos_sorcerer_shadow_barded_chaos_steed	1
wh_dlc01_anc_mount_chs_chaos_sorcerer_shadow_chaos_steed	wh_dlc01_skill_chs_wizard_unique_chaos_sorcerer_shadow_chaos_steed	1
wh_dlc01_anc_mount_chs_chaos_sorcerer_shadow_manticore	wh_dlc01_skill_chs_wizard_unique_chaos_sorcerer_shadow_manticore	1
wh_dlc01_anc_mount_chs_exalted_hero_manticore	wh_main_skill_chs_champion_unique_exalted_hero_manticore	1
wh_dlc01_anc_mount_nor_chaos_sorcerer_lord_warhorse	wh_main_skill_nor_lord_unique_chaos_sorcerer_lord_warhorse	1
wh_dlc03_anc_mount_emp_amber_wizard_barded_warhorse	wh_dlc03_skill_emp_wizard_unique_amber_wizard_barded_warhorse	1
wh_dlc03_anc_mount_emp_amber_wizard_imperial_griffon	wh_dlc03_skill_emp_wizard_unique_amber_wizard_imperial_griffon	1
wh_dlc03_anc_mount_emp_amber_wizard_imperial_pegasus	wh_dlc03_skill_emp_wizard_unique_amber_wizard_imperial_pegasus	1
wh_dlc03_anc_mount_emp_amber_wizard_warhorse	wh_dlc03_skill_emp_wizard_unique_amber_wizard_warhorse	1
wh_dlc03_anc_mount_emp_boris_todbringer_barded_warhorse	wh_dlc03_skill_emp_lord_unique_boris_todbringer_barded_warhorse	1
wh_dlc03_bst_cha_beastlord_1	wh_dlc03_skill_bst_beastlord_unique_razorgor	1
wh_dlc03_bst_cha_bray_shaman_beasts_1	wh_dlc03_skill_bst_bray_shaman_beasts_unique_razorgor	1
wh_dlc03_bst_cha_bray_shaman_death_1	wh_dlc03_skill_bst_bray_shaman_death_unique_razorgor	1
wh_dlc03_bst_cha_bray_shaman_shadows_1	wh_dlc03_skill_bst_bray_shaman_shadows_unique_razorgor	1
wh_dlc03_bst_cha_bray_shaman_wild_1	wh_dlc03_skill_bst_bray_shaman_wild_unique_razorgor	1
wh_dlc03_bst_cha_khazrak_one_eye_1	wh_dlc03_skill_bst_khazrak_one_eye_unique_razorgor	1
wh_dlc04_anc_mount_emp_arch_lector_barded_warhorse	wh_dlc04_skill_emp_lord_unique_arch_lector_barded_warhorse	1
wh_dlc04_anc_mount_emp_arch_lector_warhorse	wh_dlc04_skill_emp_lord_unique_arch_lector_warhorse	1
wh_dlc04_anc_mount_emp_volkmar_the_grim_altar_of_sigmar	wh_dlc04_skill_emp_lord_unique_volkmar_the_grim_altar_of_sigmar	1
wh_dlc04_anc_mount_emp_volkmar_the_grim_barded_warhorse	wh_dlc04_skill_emp_lord_unique_volkmar_the_grim_barded_warhorse	1
wh_dlc04_anc_mount_emp_volkmar_the_grim_warhorse	wh_dlc04_skill_emp_lord_unique_volkmar_the_grim_warhorse	1
wh_dlc04_anc_mount_vmp_helman_ghorst_corpse_cart	wh_dlc04_skill_vmp_lord_unique_helman_ghorst_corpse_cart	1
wh_dlc04_anc_mount_vmp_master_necromancer_corpse_cart_balefire	wh_dlc04_skill_vmp_lord_unique_necromancer_corpse_cart_balefire	1
wh_dlc04_anc_mount_vmp_master_necromancer_corpse_cart_unholy_lodestone	wh_dlc04_skill_vmp_lord_unique_necromancer_corpse_cart_lodestone	1
wh_dlc04_anc_mount_vmp_master_necromancer_corpse_cart	wh_dlc04_skill_vmp_lord_unique_necromancer_corpse_cart	1
wh_dlc04_anc_mount_vmp_necromancer_corpse_cart_balefire	wh_dlc04_skill_vmp_wizard_unique_necromancer_corpse_cart_balefire	1
wh_dlc04_anc_mount_vmp_necromancer_corpse_cart_unholy_lodestone	wh_dlc04_skill_vmp_wizard_unique_necromancer_corpse_cart_lodestone	1
wh_dlc04_anc_mount_vmp_necromancer_corpse_cart	wh_dlc04_skill_vmp_wizard_unique_necromancer_corpse_cart	1
wh_dlc04_anc_mount_vmp_strigoi_ghoul_king_terrorgheist	wh_dlc04_skill_vmp_lord_unique_strigoi_ghoul_king_terrorgheist	1
wh_dlc05_anc_mount_emp_grey_wizard_barded_warhorse	wh_dlc05_skill_emp_wizard_unique_grey_wizard_barded_warhorse	1
wh_dlc05_anc_mount_emp_grey_wizard_imperial_pegasus	wh_dlc05_skill_emp_wizard_unique_grey_wizard_pegasus	1
wh_dlc05_anc_mount_emp_grey_wizard_warhorse	wh_dlc05_skill_emp_wizard_unique_grey_wizard_warhorse	1
wh_dlc05_anc_mount_emp_jade_wizard_barded_warhorse	wh_dlc05_skill_emp_wizard_unique_jade_wizard_barded_warhorse	1
wh_dlc05_anc_mount_emp_jade_wizard_imperial_pegasus	wh_dlc05_skill_emp_wizard_unique_jade_wizard_pegasus	1
wh_dlc05_anc_mount_emp_jade_wizard_warhorse	wh_dlc05_skill_emp_wizard_unique_jade_wizard_warhorse	1
wh_dlc05_anc_mount_vmp_red_duke_barded_nightmare	wh_dlc05_skill_vmp_lord_unique_red_duke_barded_nightmare	1
wh_dlc05_anc_mount_vmp_red_duke_hellsteed	wh_dlc05_skill_vmp_lord_unique_red_duke_hellsteed	1
wh_dlc05_anc_mount_vmp_red_duke_zombie_dragon	wh_dlc05_skill_vmp_lord_unique_red_duke_zombie_dragon	1
wh_dlc05_anc_mount_vmp_vampire_shadow_barded_nightmare	wh_dlc05_skill_vmp_dignitary_shadow_unique_vampire_barded_nightmare	1
wh_dlc05_anc_mount_vmp_vampire_shadow_hellsteed	wh_dlc05_skill_vmp_dignitary_shadow_unique_vampire_hellsteed	1
wh_dlc05_anc_mount_wef_glade_lord_elven_steed_fem	wh_dlc05_skill_wef_glade_lord_unique_elven_steed_fem	1
wh_dlc05_anc_mount_wef_glade_lord_elven_steed	wh_dlc05_skill_wef_glade_lord_unique_elven_steed	1
wh_dlc05_anc_mount_wef_glade_lord_forest_dragon_fem	wh_dlc05_skill_wef_glade_lord_unique_forest_dragon_fem	1
wh_dlc05_anc_mount_wef_glade_lord_forest_dragon	wh_dlc05_skill_wef_glade_lord_unique_forest_dragon	1
wh_dlc05_anc_mount_wef_glade_lord_great_eagle_fem	wh_dlc05_skill_wef_glade_lord_unique_great_eagle_fem	1
wh_dlc05_anc_mount_wef_glade_lord_great_eagle	wh_dlc05_skill_wef_glade_lord_unique_great_eagle	1
wh_dlc05_anc_mount_wef_spellsinger_beast_elven_steed	wh_dlc05_skill_wef_spellsinger_beasts_unique_elven_steed	1
wh_dlc05_anc_mount_wef_spellsinger_beast_great_eagle	wh_dlc05_skill_wef_spellsinger_beasts_unique_great_eagle	1
wh_dlc05_anc_mount_wef_spellsinger_beast_unicorn	wh_dlc05_skill_wef_spellsinger_beasts_unique_unicorn	1
wh_dlc05_anc_mount_wef_spellsinger_life_elven_steed	wh_dlc05_skill_wef_spellsinger_life_unique_elven_steed	1
wh_dlc05_anc_mount_wef_spellsinger_life_great_eagle	wh_dlc05_skill_wef_spellsinger_life_unique_great_eagle	1
wh_dlc05_anc_mount_wef_spellsinger_life_unicorn	wh_dlc05_skill_wef_spellsinger_life_unique_unicorn	1
wh_dlc05_anc_mount_wef_spellsinger_shadow_elven_steed	wh_dlc05_skill_wef_spellsinger_shadow_unique_elven_steed	1
wh_dlc05_anc_mount_wef_spellsinger_shadow_great_eagle	wh_dlc05_skill_wef_spellsinger_shadow_unique_great_eagle	1
wh_dlc05_anc_mount_wef_spellsinger_shadow_unicorn	wh_dlc05_skill_wef_spellsinger_shadow_unique_unicorn	1
wh_dlc06_anc_mount_dwf_runelord_anvil_of_doom	wh_dlc06_skill_dwf_runelord_anvil_of_doom	1
wh_dlc06_anc_mount_grn_night_goblin_warboss_great_cave_squig	wh_dlc06_skill_grn_night_goblin_warboss_great_cave_squig	1
wh_dlc06_anc_mount_grn_wurrzag_spleenrippa	wh_dlc06_skill_grn_wurrzag_da_great_prophet_spleenrippa	1
wh_dlc06_anc_rune_rune_of_fury	wh_dlc06_skill_dwf_runelord_self_rune_of_fury	1
wh_dlc06_anc_rune_rune_of_might	wh_dlc06_skill_dwf_runelord_self_rune_of_might	1
wh_dlc06_anc_rune_rune_of_parrying	wh_dlc06_skill_dwf_runelord_self_rune_of_parrying	1
wh_dlc06_anc_rune_rune_of_striking	wh_dlc06_skill_dwf_runelord_self_rune_of_striking	1
wh_dlc07_anc_mount_brt_alberic_barbed_warhorse	wh_dlc07_skill_brt_alberic_unique_general_barded_warhorse	1
wh_dlc07_anc_mount_brt_alberic_royal_hipppogryph	wh_dlc07_skill_brt_alberic_unique_general_hippogryph	1
wh_dlc07_anc_mount_brt_alberic_royal_pegasus	wh_dlc07_skill_brt_alberic_unique_general_royal_pegasus	1
wh_dlc07_anc_mount_brt_damsel_beasts_unicorn	wh_dlc07_skill_brt_damsel_beasts_unique_unicorn	1
wh_dlc07_anc_mount_brt_damsel_heavens_unicorn	wh_dlc07_skill_brt_damsel_heavens_unique_unicorn	1
wh_dlc07_anc_mount_brt_damsel_life_unicorn	wh_dlc07_skill_brt_damsel_life_unique_unicorn	1
wh_dlc07_anc_mount_brt_fay_enchantress_silvaron	wh_dlc07_skill_brt_fay_enchantress_unique_silvaron	1
wh_dlc07_anc_mount_brt_prophetess_beasts_brettonian_warhorse_barded	wh_dlc07_skill_brt_prophetess_beasts_unique_brettonian_barded_warhorse	1
wh_dlc07_anc_mount_brt_prophetess_beasts_brettonian_warhorse	wh_dlc07_skill_brt_prophetess_beasts_unique_brettonian_warhorse	1
wh_dlc07_anc_mount_brt_prophetess_beasts_royal_pegasus	wh_dlc07_skill_brt_prophetess_beasts_unique_brettonian_royal_pegasus	1
wh_dlc07_anc_mount_brt_prophetess_brettonian_warhorse_barded	wh_dlc07_skill_brt_prophetess_unique_brettonian_barded_warhorse	1
wh_dlc07_anc_mount_brt_prophetess_brettonian_warhorse	wh_dlc07_skill_brt_prophetess_unique_brettonian_warhorse	1
wh_dlc07_anc_mount_brt_prophetess_life_brettonian_warhorse_barded	wh_dlc07_skill_brt_prophetess_life_unique_brettonian_barded_warhorse	1
wh_dlc07_anc_mount_brt_prophetess_life_brettonian_warhorse	wh_dlc07_skill_brt_prophetess_life_unique_brettonian_warhorse	1
wh_dlc07_anc_mount_brt_prophetess_life_royal_pegasus	wh_dlc07_skill_brt_prophetess_life_unique_brettonian_royal_pegasus	1
wh_dlc07_anc_mount_brt_prophetess_royal_pegasus	wh_dlc07_skill_brt_prophetess_unique_brettonian_royal_pegasus	1
wh_dlc08_anc_mount_nor_chieftain_marauder_chariot	wh_dlc08_skill_nor_chieftain_unique_marauder_chariot	1
wh_dlc08_anc_mount_nor_chieftain_norscan_warhorse	wh_dlc08_skill_nor_chieftain_unique_norscan_warhorse	1
wh_dlc08_anc_mount_nor_chieftain_war_mammoth	wh_dlc08_skill_nor_chieftain_unique_war_mammoth	1
wh_dlc08_anc_mount_nor_shaman_sorcerer_death_marauder_chariot	wh_dlc08_skill_nor_shaman_death_unique_marauder_chariot	1
wh_dlc08_anc_mount_nor_shaman_sorcerer_death_norscan_warhorse	wh_dlc08_skill_nor_shaman_death_unique_norscan_warhorse	1
wh_dlc08_anc_mount_nor_shaman_sorcerer_fire_marauder_chariot	wh_dlc08_skill_nor_shaman_fire_unique_marauder_chariot	1
wh_dlc08_anc_mount_nor_shaman_sorcerer_fire_norscan_warhorse	wh_dlc08_skill_nor_shaman_fire_unique_norscan_warhorse	1
wh_dlc08_anc_mount_nor_shaman_sorcerer_metal_marauder_chariot	wh_dlc08_skill_nor_shaman_metal_unique_marauder_chariot	1
wh_dlc08_anc_mount_nor_shaman_sorcerer_metal_norscan_warhorse	wh_dlc08_skill_nor_shaman_metal_unique_norscan_warhorse	1
wh_dlc08_anc_mount_nor_wulfrik_marauder_chariot	wh_dlc08_skill_nor_wulfrik_unique_marauder_chariot	1
wh_dlc08_anc_mount_nor_wulfrik_norscan_warhorse	wh_dlc08_skill_nor_wulfrik_unique_norscan_warhorse	1
wh_dlc08_anc_mount_nor_wulfrik_war_mammoth	wh_dlc08_skill_nor_wulfrik_unique_war_mammoth	1
wh_main_anc_mount_brt_damsel_beasts_warhorse	wh_main_skill_brt_wizard_unique_damsel_beasts_warhorse	1
wh_main_anc_mount_brt_damsel_life_warhorse	wh_main_skill_brt_wizard_unique_damsel_life_warhorse	1
wh_main_anc_mount_brt_damsel_warhorse	wh_main_skill_brt_wizard_unique_damsel_warhorse	1
wh_main_anc_mount_brt_general_barded_warhorse	wh_main_skill_brt_lord_unique_general_barded_warhorse	1
wh_main_anc_mount_brt_general_hippogryph	wh_main_skill_brt_lord_unique_general_hippogryph	1
wh_main_anc_mount_brt_general_royal_pegasus	wh_main_skill_brt_lord_unique_general_royal_pegasus	1
wh_main_anc_mount_brt_louen_beaquis	wh_main_skill_brt_lord_unique_louen_beaquis	1
wh_main_anc_mount_brt_louen_royal_pegasus	wh_main_skill_brt_lord_unique_louen_royal_pegasus	1
wh_main_anc_mount_brt_paladin_barded_warhorse	wh_main_skill_brt_champion_unique_paladin_barded_warhorse	1
wh_main_anc_mount_brt_paladin_pegasus	wh_main_skill_brt_champion_unique_paladin_pegasus	1
wh_main_anc_mount_chs_archaon_dorghar	wh_main_skill_chs_lord_unique_archaon_dorghar	1
wh_main_anc_mount_chs_chaos_lord_barded_chaos_steed	wh_main_skill_chs_lord_unique_chaos_lord_barded_chaos_steed	1
wh_main_anc_mount_chs_chaos_lord_chaos_steed	wh_main_skill_chs_lord_unique_chaos_lord_chaos_steed	1
wh_main_anc_mount_chs_chaos_sorcerer_death_barded_chaos_steed	wh_main_skill_chs_wizard_unique_chaos_sorcerer_death_barded_chaos_steed	1
wh_main_anc_mount_chs_chaos_sorcerer_death_chaos_steed	wh_main_skill_chs_wizard_unique_chaos_sorcerer_death_chaos_steed	1
wh_main_anc_mount_chs_chaos_sorcerer_death_manticore	wh_main_skill_chs_wizard_unique_chaos_sorcerer_death_manticore	1
wh_main_anc_mount_chs_chaos_sorcerer_fire_barded_chaos_steed	wh_main_skill_chs_wizard_unique_chaos_sorcerer_fire_barded_chaos_steed	1
wh_main_anc_mount_chs_chaos_sorcerer_fire_chaos_steed	wh_main_skill_chs_wizard_unique_chaos_sorcerer_fire_chaos_steed	1
wh_main_anc_mount_chs_chaos_sorcerer_fire_manticore	wh_main_skill_chs_wizard_unique_chaos_sorcerer_fire_manticore	1
wh_main_anc_mount_chs_chaos_sorcerer_metal_barded_chaos_steed	wh_main_skill_chs_wizard_unique_chaos_sorcerer_metal_barded_chaos_steed	1
wh_main_anc_mount_chs_chaos_sorcerer_metal_chaos_steed	wh_main_skill_chs_wizard_unique_chaos_sorcerer_metal_chaos_steed	1
wh_main_anc_mount_chs_chaos_sorcerer_metal_manticore	wh_main_skill_chs_wizard_unique_chaos_sorcerer_metal_manticore	1
wh_main_anc_mount_chs_exalted_hero_barded_chaos_steed	wh_main_skill_chs_champion_unique_exalted_hero_barded_chaos_steed	1
wh_main_anc_mount_chs_exalted_hero_chaos_steed	wh_main_skill_chs_champion_unique_exalted_hero_chaos_steed	1
wh_main_anc_mount_emp_balthasar_imperial_pegasus	wh_main_skill_emp_lord_unique_balthasar_imperial_pegasus	1
wh_main_anc_mount_emp_balthasar_warhorse	wh_main_skill_emp_lord_unique_balthasar_warhorse	1
wh_main_anc_mount_emp_bright_wizard_barded_warhorse	wh_main_skill_emp_wizard_unique_bright_wizard_barded_warhorse	1
wh_main_anc_mount_emp_bright_wizard_imperial_pegasus	wh_main_skill_emp_wizard_unique_bright_wizard_imperial_pegasus	1
wh_main_anc_mount_emp_bright_wizard_warhorse	wh_main_skill_emp_wizard_unique_bright_wizard_warhorse	1
wh_main_anc_mount_emp_captain_barded_warhorse	wh_main_skill_emp_champion_unique_captain_barded_warhorse	1
wh_main_anc_mount_emp_captain_imperial_pegasus	wh_main_skill_emp_champion_unique_captain_imperial_pegasus	1
wh_main_anc_mount_emp_captain_warhorse	wh_main_skill_emp_champion_unique_captain_warhorse	1
wh_main_anc_mount_emp_celestial_wizard_barded_warhorse	wh_main_skill_emp_wizard_unique_celestial_wizard_barded_warhorse	1
wh_main_anc_mount_emp_celestial_wizard_imperial_pegasus	wh_main_skill_emp_wizard_unique_celestial_wizard_imperial_pegasus	1
wh_main_anc_mount_emp_celestial_wizard_warhorse	wh_main_skill_emp_wizard_unique_celestial_wizard_warhorse	1
wh_main_anc_mount_emp_general_barded_warhorse	wh_main_skill_emp_lord_unique_general_barded_warhorse	1
wh_main_anc_mount_emp_general_imperial_griffon	wh_main_skill_emp_lord_unique_general_imperial_griffon	1
wh_main_anc_mount_emp_general_imperial_pegasus	wh_main_skill_emp_lord_unique_general_imperial_pegasus	1
wh_main_anc_mount_emp_general_warhorse	wh_main_skill_emp_lord_unique_general_warhorse	1
wh_main_anc_mount_emp_karl_franz_barded_warhorse	wh_main_skill_emp_lord_unique_karl_franz_barded_warhorse	1
wh_main_anc_mount_emp_karl_franz_deathclaw	wh_main_skill_emp_lord_unique_karl_franz_deathclaw	1
wh_main_anc_mount_emp_karl_franz_imperial_pegasus	wh_main_skill_emp_lord_unique_karl_franz_imperial_pegasus	1
wh_main_anc_mount_emp_karl_franz_warhorse	wh_main_skill_emp_lord_unique_karl_franz_warhorse	1
wh_main_anc_mount_emp_light_wizard_barded_warhorse	wh_main_skill_emp_wizard_unique_light_wizard_barded_warhorse	1
wh_main_anc_mount_emp_light_wizard_imperial_pegasus	wh_main_skill_emp_wizard_unique_light_wizard_imperial_pegasus	1
wh_main_anc_mount_emp_light_wizard_warhorse	wh_main_skill_emp_wizard_unique_light_wizard_warhorse	1
wh_main_anc_mount_emp_warrior_priest_barded_warhorse	wh_main_skill_emp_dignitary_unique_warrior_priest_barded_warhorse	1
wh_main_anc_mount_emp_warrior_priest_warhorse	wh_main_skill_emp_dignitary_unique_warrior_priest_warhorse	1
wh_main_anc_mount_grn_azhag_skullmuncha	wh_main_skill_grn_lord_unique_azhag_skullmuncha	1
wh_main_anc_mount_grn_goblin_big_boss_giant_spider	wh_main_skill_grn_spy_unique_goblin_big_boss_giant_spider	1
wh_main_anc_mount_grn_goblin_big_boss_giant_wolf	wh_main_skill_grn_spy_unique_goblin_big_boss_giant_wolf	1
wh_main_anc_mount_grn_goblin_great_shaman_giant_wolf	wh_main_skill_grn_lord_unique_goblin_great_shaman_giant_wolf	1
wh_main_anc_mount_grn_orc_warboss_war_boar	wh_main_skill_grn_lord_unique_orc_warboss_war_boar	1
wh_main_anc_mount_grn_orc_warboss_wyvern	wh_main_skill_grn_lord_unique_orc_warboss_wyvern	1
wh_main_anc_mount_grn_wizard_orc_shaman_war_boar	wh_main_skill_grn_wizard_unique_orc_shaman_war_boar	1
wh_main_anc_mount_ksl_captain_barded_warhorse	wh_main_skill_ksl_champion_unique_captain_warhorse	2
wh_main_anc_mount_ksl_captain_warhorse	wh_main_skill_ksl_champion_unique_captain_warhorse	1
wh_main_anc_mount_ksl_celestial_wizard_warhorse	wh_main_skill_ksl_wizard_unique_celestial_wizard_warhorse	1
wh_main_anc_mount_ksl_general_barded_warhorse	wh_main_skill_ksl_lord_unique_general_warhorse	2
wh_main_anc_mount_ksl_general_warhorse	wh_main_skill_ksl_lord_unique_general_warhorse	1
wh_main_anc_mount_nor_chaos_sorcerer_warhorse	wh_main_skill_nor_wizard_unique_chaos_sorcerer_metal_warhorse	1
wh_main_anc_mount_nor_marauder_chieftain_warhorse	wh_main_skill_nor_lord_unique_marauder_chieftain_warhorse	1
wh_main_anc_mount_teb_bright_wizard_warhorse	wh_main_skill_teb_wizard_unique_bright_wizard_warhorse	1
wh_main_anc_mount_teb_captain_barded_warhorse	wh_main_skill_teb_champion_unique_captain_warhorse	2
wh_main_anc_mount_teb_captain_warhorse	wh_main_skill_teb_champion_unique_captain_warhorse	1
wh_main_anc_mount_teb_general_barded_warhorse	wh_main_skill_teb_lord_unique_general_warhorse	2
wh_main_anc_mount_teb_general_warhorse	wh_main_skill_teb_lord_unique_general_warhorse	1
wh_main_anc_mount_vmp_mannfred_barded_nightmare	wh_main_skill_vmp_lord_unique_mannfred_barded_nightmare	1
wh_main_anc_mount_vmp_mannfred_hellsteed	wh_main_skill_vmp_lord_unique_mannfred_hellsteed	1
wh_main_anc_mount_vmp_mannfred_zombie_dragon	wh_main_skill_vmp_lord_unique_mannfred_zombie_dragon	1
wh_main_anc_mount_vmp_master_necromancer_barded_nightmare	wh_main_skill_vmp_lord_unique_necromancer_barded_nightmare	1
wh_main_anc_mount_vmp_master_necromancer_hellsteed	wh_main_skill_vmp_lord_unique_necromancer_hellsteed	1
wh_main_anc_mount_vmp_necromancer_nightmare	wh_main_skill_vmp_wizard_unique_necromancer_nightmare	1
wh_main_anc_mount_vmp_vampire_barded_nightmare	wh_main_skill_vmp_dignitary_unique_vampire_barded_nightmare	1
wh_main_anc_mount_vmp_vampire_hellsteed	wh_main_skill_vmp_dignitary_unique_vampire_hellsteed	1
wh_main_anc_mount_vmp_vampire_lord_barded_nightmare	wh_main_skill_vmp_lord_unique_vampire_lord_barded_nightmare	1
wh_main_anc_mount_vmp_vampire_lord_hellsteed	wh_main_skill_vmp_lord_unique_vampire_lord_hellsteed	1
wh_main_anc_mount_vmp_vampire_lord_zombie_dragon	wh_main_skill_vmp_lord_unique_vampire_lord_zombie_dragon	1
wh_main_anc_mount_vmp_wight_king_barded_skeletal_steed	wh_main_skill_vmp_champion_unique_wight_king_barded_skeletal_steed	1
wh_main_anc_mount_vmp_wight_king_skeletal_steed	wh_main_skill_vmp_champion_unique_wight_king_skeletal_steed	1
wh_main_anc_rune_rune_of_fury	wh_main_skill_dwf_runesmith_self_rune_of_fury	1
wh_main_anc_rune_rune_of_might	wh_main_skill_dwf_runesmith_self_rune_of_might	1
wh_main_anc_rune_rune_of_parrying	wh_main_skill_dwf_runesmith_self_rune_of_parrying	1
wh_main_anc_rune_rune_of_striking	wh_main_skill_dwf_runesmith_self_rune_of_striking	1
wh_pro01_anc_rune_rune_of_fury	wh_pro01_anc_rune_rune_of_fury	1
wh_pro01_anc_rune_rune_of_might	wh_pro01_anc_rune_rune_of_might	1
wh_pro01_anc_rune_rune_of_parrying	wh_pro01_anc_rune_rune_of_parrying	1
wh_pro01_anc_rune_rune_of_striking	wh_pro01_anc_rune_rune_of_striking	1
wh_pro02_anc_mount_vmp_isabella_barded_nightmare	wh_pro02_skill_vmp_lord_unique_isabella_barded_nightmare	1
wh_pro02_anc_mount_vmp_isabella_hellsteed	wh_pro02_skill_vmp_lord_unique_isabella_hellsteed	1
