Loc PackedFile	1
key	text	tooltip
battles_description_wh_main_mp_eschen	 	true
battles_localised_name_wh2_main_chokepoint_norsca_chasm	Ironfrost Chasm	true
battles_localised_name_wh2_dlc09_siege_city_q_tmb	Lybaras - Tomb Kings	true
battles_localised_name_wh2_dlc09_siege_city_p_tmb	Khemri - Tomb Kings	true
battles_localised_name_wh2_dlc09_siege_city_h_tmb	Lahmia - Tomb Kings	true
battles_localised_name_wh2_dlc09_siege_city_b_tmb	Black Tower of Arkhan - Tomb Kings	true
battles_localised_name_wh2_dlc09_siege_city_d_tmb	Numas - Tomb Kings	true
battles_localised_name_wh2_dlc09_siege_city_f_tmb	Ka-Sabar - Tomb Kings	true
battles_description_wh_dlc05_wef_qb_battle_of_the_cairns	 	true
battles_description_wh2_qb_dlc11_cst_noctilus_desert	 	true
battles_localised_name_wh2_qb_warp_shard_armour	Warp-Shard Caverns	true
battles_localised_name_wh2_qb_arnheim	Arnheim	true
battles_localised_name_wh2_qb_dlc09_staff_of_nagash	The Black Tower of Arkhan	true
battles_localised_name_wh_main_qb_qb_barrier_idols_v2	The Lost Idols	true
battles_description_def_pet_hills_infield_a_3	 	true
battles_localised_name_wh2_dlc11_cst_island_3_tombking	The Dragon Isles (Tomb Kings)	true
battles_localised_name_wh_main_qb_qb_southern_chaos_wastes	Southern Chaos Wastes	true
battles_localised_name_wh_main_qb_qb_northern_chaos_wastes	Northern Chaos Wastes	true
battles_localised_name_wh_dlc05_wef_qb_night_glens	The Night Glens	true
battles_localised_name_lzd_river_infield_a_1_ambush	Qu'ittax	true
battles_description_wh_main_mp_karak_azgal	 	true
battles_localised_name_wh2_dlc09_unfortified_tmb_b	Palace of the Golden Skull	true
battles_localised_name_wh2_dlc09_unfortified_tmb_c	Seat of Pharakh	true
battles_localised_name_wh2_dlc09_unfortified_tmb_a	City of the Mighty Flame	true
battles_localised_name_wh2_dlc09_unfortified_tmb_d	Necropolis of Numas	true
battles_localised_name_wh2_dlc09_unfortified_tmb_e	Dead City of the Salt Plain	true
battles_localised_name_wh_main_qb_qb_kelp_and_koldust	Kelp & Koldust	true
battles_localised_name_wh2_qb_dlc09_pits_of_zardok	Pits of Zardok	true
battles_localised_name_wh2_qb_tower_of_hoeth	Tower of Hoeth	true
battles_localised_name_wh_main_empire_intro	The Siege of Altdorf	true
battles_localised_name_wh2_qb_dlc11_cylostra_shifting_isles	Shifting Isles	true
battles_description_wh2_main_chokepoint_def_chasm_b	 	true
battles_description_def_ravine_infield_a_1	 	true
battles_localised_name_wh_qb_dlc08_wintertooth_crown	Wintertooth Crown	true
battles_localised_name_def_coast_infield_a_4	Spite Reach	true
battles_localised_name_def_coast_infield_a_3	Doom Glades	true
battles_localised_name_lzd_coast_infield_a_5	lzd_coast_infield_a_5	true
battles_localised_name_lzd_coast_infield_a_2	The Golden Colossus	true
battles_localised_name_lzd_coast_infield_a_3	lzd_coast_infield_a_3	true
battles_localised_name_lzd_coast_infield_a_1	lzd_coast_infield_a_1	true
battles_description_def_plains_infield_a_4	 	true
battles_description_def_plains_infield_a_5	 	true
battles_description_wh2_main_chokepoint_lzd_lustria_river_b	 	true
battles_localised_name_wh_main_vampire_counts_intro	The Siege of Castle Drakenhof	true
battles_localised_name_wh_main_qb_qb_estalian_tomb	Estalian Tomb	true
battles_localised_name_wh_main_mp_oakenhammer	Oakenhammer	true
battles_description_wh_dlc04_qb_qb_mordheim_ruin	 	true
battles_description_wh_main_qb_qb_marbads_tomb_ambush	 	true
battles_description_def_nor_river_infield_a_3	 	true
battles_localised_name_wh_dlc03_bst_beast_ambush_03	The Black Deeps	true
battles_localised_name_wh_dlc03_bst_beast_ambush_02	The Great Forest	true
battles_localised_name_wh_dlc03_bst_beast_ambush_01	The Heart of the Dark 	true
battles_description_wh_main_mp_karak_ungor	 	true
battles_localised_name_wh2_qb_fallen_gates	Fallen Gates	true
battles_localised_name_wh_dlc05_wef_qb_spear_of_kurnous	The Oak of Ages	true
battles_localised_name_wh2_qb_dlc11_cylostra_shifting_isles_desert	Shifting Isles Desert	true
battles_description_wh_main_mp_norden	 	true
battles_localised_name_wh_main_mp_languille	L'Anguille	true
battles_localised_name_wh_main_mp_waldenhof	Waldenhof	true
battles_description_wh_dlc05_wef_qb_the_ashenhall	 	true
battles_localised_name_def_desert_ravine_infield_a_2	Wamp Rat Gulch	true
battles_description_wh_main_qb_qb_blackfire_pass_v2	 	true
battles_description_def_forest_infield_a_3	 	true
battles_description_wh2_qb_dlc12_lord_kroak	 	true
battles_localised_name_wh_main_mp_volksgrad	Volksgrad	true
battles_localised_name_wh2_mp_shrine_of_khaine_04	Duskwatch Plateau	true
battles_localised_name_wh2_mp_shrine_of_khaine_05	The Wasteland	true
battles_localised_name_wh2_mp_shrine_of_khaine_02	The Dead Shore	true
battles_localised_name_wh2_mp_shrine_of_khaine_03	Ruins of Enduil	true
battles_localised_name_wh2_mp_shrine_of_khaine_01	Shrine of Khaine	true
battles_localised_name_wh2_main_chokepoint_southland_river	Green River	true
battles_localised_name_def_desert_plains_infield_a_4	Oasis of False Hope	true
battles_description_wh2_qb_dlc11_cst_noctilus_rocky	 	true
battles_localised_name_wh_main_mp_castle_drakenhof	Castle Drakenhof	true
battles_localised_name_wh_main_qb_qb_lost_vault_of_king_lunn	Lost Vault of King Lunn	true
battles_description_ult_mtn_pass_infield_a_2	 	true
battles_description_lzd_plains_infield_a_1	 	true
battles_description_lzd_plains_infield_a_3	 	true
battles_description_lzd_plains_infield_a_2	 	true
battles_description_lzd_plains_infield_a_5	 	true
battles_description_lzd_plains_infield_a_4	 	true
battles_description_lzd_plains_infield_a_6	 	true
battles_description_wh2_mp_ffa_05_1	 	true
battles_description_wh2_mp_ffa_05_3	 	true
battles_description_wh2_mp_ffa_05_2	 	true
battles_description_wh2_mp_ffa_05_4	 	true
battles_description_wh_mp_crossroads	 	true
battles_localised_name_ult_river_infield_a_2	River Vilu	true
battles_localised_name_lzd_lakes_infield_a_5	Xuhua Lake	true
battles_localised_name_lzd_lakes_infield_a_2	Temple of Huanchi	true
battles_localised_name_wh2_qb_dlc09_ash_river	Ash River	true
battles_localised_name_def_river_infield_a_2	Sulphur River	true
battles_localised_name_lzd_river_infield_a_2	River Amaxon	true
battles_localised_name_ult_lakes_infield_a_3	Mirror Woods	true
battles_localised_name_ult_lakes_infield_a_2	Athel Tamarha	true
battles_description_wh_main_qb_qb_high_pass	 	true
battles_localised_name_wh_main_qb_qb_cliff_of_beasts	Cliff Of Beasts	true
battles_localised_name_wh_main_qb_qb_leitziger_ford	Leitziger Ford	true
battles_description_wh_main_subterranean_e	 	true
battles_description_wh_main_subterranean_d	 	true
battles_localised_name_wh_main_qb_qb_black_fire_pass	Black Fire Pass	true
battles_description_wh_main_subterranean_a	 	true
battles_description_wh_main_subterranean_c	 	true
battles_description_wh_main_subterranean_b	 	true
battles_description_wh_dlc05_wef_qb_silver_spire	 	true
battles_localised_name_wh2_dlc11_qb_skjold	Skjold	true
battles_localised_name_def_desert_hills_infield_a_2	Plain of Spiders	true
battles_localised_name_wh_main_qb_qb_bloodpine_woods	Bloodpine Woods	true
battles_description_wh2_qb_dlc11_cst_noctilus_snowy	 	true
battles_localised_name_wh2_main_chokepoint_grassland_river	Alluvial Plain	true
battles_localised_name_wh2_main_subterranean_b_skv	Warpblade Tunnels	true
battles_localised_name_wh2_main_subterranean_c_skv	Gnaw Pit	true
battles_localised_name_wh2_main_subterranean_a_skv	The Black Chasm	true
battles_localised_name_wh_main_dwarfs_intro	The Battle of Karaz-a-Karak	true
battles_localised_name_wh2_qb_dlc09_pack_ice_bay	Pack Ice Bay	true
battles_description_wh2_dlc12_island_snowy_01	.	true
battles_description_wh2_dlc12_island_snowy_03	.	true
battles_description_wh2_dlc12_island_snowy_02	.	true
battles_description_wh2_main_chokepoint_generic_mountain_pass	 	true
battles_description_wh_dlc04_qb_qb_excavation_site	 	true
battles_localised_name_def_bleak_plains_infield_a_2_ambush	Grey Guardians	true
battles_description_ult_plains_infield_a_4	 	true
battles_description_ult_plains_infield_a_3	 	true
battles_description_wh2_main_chokepoint_def_grassland_river	 	true
battles_localised_name_wh2_main_chokepoint_norsca_river	Troubled Waters	true
battles_localised_name_wh2_dlc11_siege_city_g_cst	Grey Rock Point - Vampire Coast	true
battles_localised_name_wh2_dlc11_siege_city_f_cst	Sartosa - Vampire Coast	true
battles_localised_name_wh2_dlc11_siege_city_d_cst	The Blood Swamps - Vampire Coast	true
battles_localised_name_wh2_dlc11_siege_city_b_cst	Pox Marsh - Vampire Coast	true
battles_localised_name_wh2_dlc11_siege_city_a_cst	The Awakening - Vampire Coast	true
battles_localised_name_wh_main_qb_qb_todtheim	Todtheim	true
battles_description_wh_dlc03_qb_qb_shadow_forest	 	true
battles_description_wh_main_mp_bjornlings_gathering	 	true
battles_localised_name_wh_main_qb_qb_hel_fenn	Hel Fenn	true
battles_localised_name_lzd_swamp_infield_a_2	The Reeking Mire	true
battles_localised_name_lzd_swamp_infield_a_3	Aymara Swamps	true
battles_localised_name_wh2_main_chokepoint_southland_chasm	The Heart of Darkness	true
battles_localised_name_wh2_main_chokepoint_southland_mountain_pass	Arid Pass	true
battles_description_wh2_dlc12_island_rocky_01	.	true
battles_description_wh2_dlc12_island_rocky_03	.	true
battles_description_wh2_dlc12_island_rocky_02	.	true
battles_localised_name_lzd_lakes_infield_a_4_ambush	Lake Incatol	true
battles_localised_name_wh_main_qb_qb_bloodpine_woods_ambush	Bloodpine Woods	true
battles_description_wh_dlc03_bst_beast_path_01	 	true
battles_description_wh_dlc03_bst_beast_path_03	 	true
battles_description_wh_dlc03_bst_beast_path_02	 	true
battles_description_wh_mp_peak_pass	 	true
battles_localised_name_wh_main_qb_qb_mushroom_cave	Mushroom Cave	true
battles_localised_name_ult_hills_infield_a_3	Everale Ridge	true
battles_localised_name_wh_main_qb_qb_broken_leg_gully	Broken Leg Gully	true
battles_localised_name_wh2_qb_gouger_gully	Gouger Gully	true
battles_description_def_swamps_infield_a_1	 	true
battles_localised_name_wh_main_qb_qb_troll_country	Troll Country	true
battles_description_wh2_main_chokepoint_lzd_river_a	 	true
battles_description_wh_main_qb_qb_ancient_dragon_cave	 	true
battles_localised_name_def_desert_dunes_infield_a_2	Red Desert	true
battles_localised_name_def_desert_lakes_infield_a_3	Ironsand Desert	true
battles_localised_name_def_hills_infield_a_4_ambush	Shadow Wood	true
battles_description_def_nor_coast_infield_a_1	 	true
battles_description_wh_main_qb_qb_stir_river	 	true
battles_description_wh_main_qb_qb_burial_mound_of_grudsnik	 	true
battles_localised_name_wh2_qb_mosquito_swamps	Mosquito Swamps	true
battles_description_wh2_dlc10_shadow_forest	 	true
battles_description_wh2_qb_dlc11_lokhir_black_ark	 	true
battles_localised_name_wh_main_qb_qb_threat_from_the_north	The Northern Threat	true
battles_description_wh_dlc05_wef_settlement_hill_b	 	true
battles_description_wh_dlc05_wef_settlement_hill_a	 	true
battles_description_wh_dlc05_wef_settlement_hill_f	 	true
battles_description_wh_dlc05_wef_settlement_hill_g	 	true
battles_description_wh_dlc05_wef_settlement_hill_d	 	true
battles_description_def_mtn_pass_infield_a_3	 	true
battles_description_def_mtn_pass_infield_a_1	 	true
battles_localised_name_wh2_main_chokepoint_lzd_lustria_mountain_pass	Chasm of the Condor	true
battles_localised_name_wh_main_qb_qb_pillar_of_bone	Pillar Of Bone	true
battles_localised_name_wh2_dlc12_island_tropical_01	Tarrantula Coast Isle (Inland)	true
battles_localised_name_wh2_dlc12_island_tropical_02	Tarrantula Coast Isle (North)	true
battles_localised_name_wh2_dlc12_island_tropical_03	Tarrantula Coast Isle (South)	true
battles_description_wh_main_qb_qb_fall_of_man	 	true
battles_description_wh2_main_chokepoint_ult_grassland_river	 	true
battles_localised_name_wh2_qb_dlc11_cst_noctilus	Captain Roth’s Moondial	true
battles_description_wh2_main_siege_city_q_lzd	 	true
battles_description_wh2_main_siege_city_p_lzd	 	true
battles_description_wh2_main_siege_city_f_lzd	 	true
battles_description_wh2_main_siege_city_d_lzd	 	true
battles_description_wh2_main_siege_city_c_lzd	 	true
battles_description_wh2_main_siege_city_b_lzd	 	true
battles_description_wh2_main_siege_city_n_lzd	 	true
battles_description_wh2_main_siege_city_m_lzd	 	true
battles_description_wh2_main_siege_city_h_lzd	 	true
battles_description_wh_main_siege_city_b_brt	 	true
battles_description_wh_main_siege_city_c_brt	 	true
battles_description_wh_main_siege_city_a_brt	 	true
battles_description_wh_main_siege_city_f_brt	 	true
battles_description_wh_main_siege_city_g_brt	 	true
battles_description_wh_main_siege_city_d_brt	 	true
battles_description_wh_main_siege_city_e_brt	 	true
battles_description_wh_main_siege_city_a_grn	 	true
battles_description_wh_main_siege_city_b_grn	 	true
battles_description_wh_main_siege_city_c_grn	 	true
battles_description_wh_main_siege_city_d_grn	 	true
battles_description_wh_main_siege_city_e_grn	 	true
battles_description_wh_main_siege_city_f_grn	 	true
battles_description_wh_main_siege_city_g_grn	 	true
battles_localised_name_wh2_pro05_mp_steps_of_isha_04	Steps of Isha: Shining Summit	true
battles_localised_name_wh2_pro05_mp_steps_of_isha_01	Steps of Isha: Pit of Thorns	true
battles_localised_name_wh2_pro05_mp_steps_of_isha_02	Steps of Isha: Broken Hills	true
battles_localised_name_wh2_pro05_mp_steps_of_isha_03	Steps of Isha: Heartlands	true
battles_localised_name_wh2_qb_dlc09_charnel_valley	Charnel Valley	true
battles_localised_name_wh_dlc05_wef_settlement_hill_b	Ruins of Parravon	true
battles_localised_name_wh_dlc05_wef_settlement_hill_a	The Skymark Reaches	true
battles_localised_name_wh_dlc05_wef_settlement_hill_f	Glade of the Lost	true
battles_localised_name_wh_dlc05_wef_settlement_hill_g	Council of Beasts	true
battles_localised_name_wh_dlc05_wef_settlement_hill_d	The King's Glade	true
battles_localised_name_def_bleak_forest_infield_a_2	Cairnwoods	true
battles_description_wh2_qb_mosquito_swamps	 	true
battles_localised_name_wh_main_qb_qb_burial_mound_of_grudsnik	Burial Mound Of Grudsnik	true
battles_description_wh2_main_chokepoint_ult_plains_river	 	true
battles_description_wh_main_siege_city_a_dwf	 	true
battles_description_wh_main_siege_city_b_dwf	 	true
battles_description_wh_main_siege_city_c_dwf	 	true
battles_description_wh_main_siege_city_d_dwf	 	true
battles_description_wh_main_siege_city_e_dwf	 	true
battles_description_wh_main_siege_city_f_dwf	 	true
battles_description_wh_main_siege_city_g_dwf	 	true
battles_description_wh2_dlc12_qb_tiktaqto_mask_of_heavens	 	true
battles_localised_name_def_swamps_infield_a_1	The Broken Land	true
battles_localised_name_wh_main_qb_qb_hel_fenn_ambush	Hel Fenn	true
battles_description_wh_main_qb_qb_broken_leg_gully	 	true
battles_description_wh2_dlc11_cst_island_1_snowy	.	true
battles_description_wh2_dlc11_cst_island_2_snowy	.	true
battles_description_wh2_dlc11_cst_island_3_snowy	.	true
battles_localised_name_wh_main_mp_karag_dron	Karag Dron	true
battles_localised_name_wh_dlc03_bst_beast_path_01	The Heart of the Dark 	true
battles_localised_name_wh_dlc03_bst_beast_path_03	The Black Deeps	true
battles_localised_name_wh_dlc03_bst_beast_path_02	The Great Forest	true
battles_description_wh_main_qb_qb_shrine_of_ill_omen	 	true
battles_description_wh_main_qb_qb_hel_fenn	 	true
battles_localised_name_wh_dlc05_wef_qb_essence_of_chaos	The Essence of Chaos	true
battles_description_wh_main_qb_qb_todtheim	 	true
battles_localised_name_wh_mp_plains	MP Blue Reach River	true
battles_description_wh2_dlc11_siege_city_g_cst	 	true
battles_description_wh2_dlc11_siege_city_f_cst	 	true
battles_description_wh2_dlc11_siege_city_d_cst	 	true
battles_description_wh2_dlc11_siege_city_b_cst	 	true
battles_description_wh2_dlc11_siege_city_a_cst	 	true
battles_localised_name_wh2_dlc12_qb_ikit_claw_storm_daemon	Storm Daemon	true
battles_localised_name_ult_plains_infield_a_4	Summersong	true
battles_localised_name_ult_plains_infield_a_3	Shimmersward	true
battles_description_wh_main_greenskins_intro	 	true
battles_localised_name_def_bleak_plains_infield_a_4	Bleak Dale	true
battles_localised_name_wh_dlc04_qb_qb_excavation_site	Excavation Site	true
battles_localised_name_wh_main_mp_galbaraz	Galbaraz	true
battles_description_wh_main_qb_qb_death_pass	 	true
battles_localised_name_wh_main_qb_qb_barrier_idols	Barrier Idols	true
battles_localised_name_wh2_dlc11_cst_island_galleons_graveyard_1	The Galleon's Graveyard	true
battles_localised_name_wh2_dlc11_cst_island_galleons_graveyard_0	The Galleon's Graveyard	true
battles_localised_name_wh2_dlc11_cst_island_galleons_graveyard_2	The Galleon's Graveyard	true
battles_localised_name_wh2_dlc09_tmb_desert_infield_01_04_ambush	Valley of Thieves	true
battles_localised_name_wh2_dlc09_tmb_desert_infield_02_01_ambush	 The Desert’s Bounty	true
battles_localised_name_wh_dlc04_qb_qb_ostermark	Devastation of Ostermark	true
battles_description_wh2_qb_dlc11_cst_final_battle	 	true
battles_description_wh2_qb_altar_of_ultimate_darkness	 	true
battles_description_wh2_dlc11_cst_island_2_grassy	.	true
battles_description_wh2_dlc12_qb_tehenhauin_plaque_of_sotek	 	true
battles_description_wh2_main_siege_city_h_dwf	 	true
battles_localised_name_wh_main_subterranean_e	Coldfire Cavern	true
battles_localised_name_wh_main_subterranean_d	The Death Pass Deeps	true
battles_description_wh2_dlc11_cst_island_1_desert	.	true
battles_description_wh2_dlc11_cst_island_3_desert	.	true
battles_localised_name_wh_main_subterranean_a	The Thundering Falls	true
battles_localised_name_wh_main_subterranean_c	Volcanic Channels	true
battles_localised_name_wh_main_subterranean_b	The Black Mountains	true
battles_description_wh2_qb_dlc09_ash_river	 	true
battles_localised_name_wh_main_qb_qb_golden_monolith	Golden Monolith	true
battles_localised_name_lzd_plains_infield_a_1	lzd_plains_infield_a_1	true
battles_localised_name_lzd_plains_infield_a_3	Toothgrass Hill	true
battles_localised_name_lzd_plains_infield_a_2	lzd_plains_infield_a_2	true
battles_localised_name_lzd_plains_infield_a_5	lzd_plains_infield_a_5	true
battles_localised_name_lzd_plains_infield_a_4	Culchan Plains	true
battles_localised_name_lzd_plains_infield_a_6	lzd_plains_infield_a_6	true
battles_description_wh2_main_chokepoint_ult_forest_river	 	true
battles_localised_name_wh_main_qb_qb_broken_leg_gully_ambush	Broken Leg Gully	true
battles_description_wh2_mp_shrine_of_khaine_04	 	true
battles_description_wh2_mp_shrine_of_khaine_05	 	true
battles_description_wh2_mp_shrine_of_khaine_02	 	true
battles_description_wh2_mp_shrine_of_khaine_03	 	true
battles_description_wh2_mp_shrine_of_khaine_01	 	true
battles_description_wh2_main_siege_city_e_skv	 	true
battles_description_wh2_main_siege_city_m_skv	 	true
battles_description_wh2_main_siege_city_h_skv	 	true
battles_description_wh_dlc04_qb_qb_warpstone_mine	 	true
battles_localised_name_wh2_main_chokepoint_grassland_river_b	Flood Plain	true
battles_localised_name_def_forest_infield_a_3	The Black Forests	true
battles_localised_name_def_desert_dunes_infield_a_4_ambush	Obsidian Peaks	true
battles_description_wh_main_mp_praag	 	true
battles_localised_name_def_desert_ravine_infield_a_1_ambush	The Abyss	true
battles_localised_name_wh2_main_chokepoint_def_chasm	Blackspine Chasm	true
battles_localised_name_wh2_main_chokepoint_southland_river_b	Limpopu River	true
battles_localised_name_wh_main_mp_karak_ungor	Karak Ungor	true
battles_description_wh2_dlc11_cst_qb_harkon	.	true
battles_description_wh2_main_chokepoint_blood_river_valley_river	 	true
battles_description_wh_main_mp_oakenhammer	 	true
battles_description_wh_main_qb_qb_la_maisontaal_abbey	 	true
battles_description_wh2_main_siege_city_p_emp	 	true
battles_localised_name_def_plains_infield_a_4	Doom Gate	true
battles_localised_name_def_plains_infield_a_5	Glooming Wood	true
battles_localised_name_def_bleak_river_infield_a_3	The Pitch Flow	true
battles_localised_name_def_bleak_river_infield_a_5	The Twisted Glade	true
battles_description_def_mtn_pass_infield_a_2_ambush	 	true
battles_localised_name_wh_main_mp_dok_karaz	Dok Karaz	true
battles_localised_name_wh2_mp_shrine_of_khaine_01_land	Shrine of Khaine	true
battles_localised_name_wh_main_mp_gor_gazan	Gor Gazan	true
battles_description_wh2_qb_caverns_of_the_great_bat	 	true
battles_localised_name_def_ravine_infield_a_1	Wyvern Lake	true
battles_description_wh2_dlc11_cst_island_1_rocky	.	true
battles_description_wh2_dlc11_cst_island_2_rocky	.	true
battles_description_wh2_dlc11_cst_island_3_rocky	.	true
battles_description_wh2_mp_shrine_of_khaine_05_ambush	 	true
battles_localised_name_wh2_qb_mortuary_of_tzulaqua	Mortuary of Tzulaqua	true
battles_description_wh2_main_chokepoint_northern_river_b	 	true
battles_description_wh_dlc04_qb_qb_altdorf_outskirt	 	true
battles_description_wh2_main_chokepoint_badlands_river_b	 	true
battles_description_wh_main_qb_qb_halls_of_karak_azul	 	true
battles_description_wh_main_qb_qb_kelp_and_koldust	 	true
battles_localised_name_wh_main_mp_karak_azgal	Karak Azgal	true
battles_localised_name_wh2_final_battle	The Isle of the Dead	true
battles_localised_name_wh2_main_minor_settlement_fortress_gates	Eagle Gate - High Elves	true
battles_description_wh_qb_dlc08_sword_of_torgald	 	true
battles_description_wh2_mp_ffa_04	 	true
battles_description_wh2_mp_ffa_06	 	true
battles_description_wh2_mp_ffa_01	 	true
battles_description_wh2_mp_ffa_02	 	true
battles_description_wh2_mp_ffa_03	 	true
battles_description_wh_main_qb_qb_barrier_idols_v2	 	true
battles_description_wh_main_mp_schwartzhafen	 	true
battles_description_wh_main_mp_karak_bhufdar	 	true
battles_description_wh2_qb_arnheim	 	true
battles_description_wh_main_siege_city_f_emp	 	true
battles_description_wh_main_siege_city_f_vmp	 	true
battles_description_wh_main_siege_city_g_emp	 	true
battles_description_wh_main_siege_city_g_vmp	 	true
battles_description_wh_main_siege_city_d_emp	 	true
battles_description_wh_main_siege_city_d_vmp	 	true
battles_description_wh_main_siege_city_e_emp	 	true
battles_description_wh_main_siege_city_e_vmp	 	true
battles_description_wh_main_siege_city_b_emp	 	true
battles_description_wh_main_siege_city_b_vmp	 	true
battles_description_wh_main_siege_city_c_emp	 	true
battles_description_wh_main_siege_city_c_vmp	 	true
battles_description_wh_main_siege_city_a_emp	 	true
battles_description_wh_main_siege_city_a_vmp	 	true
battles_description_wh2_dlc09_siege_city_q_tmb	 	true
battles_description_wh2_dlc09_siege_city_p_tmb	 	true
battles_description_wh2_dlc09_siege_city_h_tmb	 	true
battles_description_wh2_dlc09_siege_city_b_tmb	 	true
battles_description_wh2_dlc09_siege_city_d_tmb	 	true
battles_description_wh2_dlc09_siege_city_f_tmb	 	true
battles_description_wh2_dlc10_qb_alith_anar_the_moon_bow	 	true
battles_description_wh2_main_siege_city_q_def	 	true
battles_description_wh2_main_siege_city_q_hef	 	true
battles_description_wh2_main_siege_city_p_def	 	true
battles_description_wh2_main_siege_city_p_hef	 	true
battles_description_wh2_main_siege_city_r_def	 	true
battles_description_wh2_main_siege_city_r_hef	 	true
battles_description_wh2_main_siege_city_e_hef	 	true
battles_description_wh2_main_siege_city_d_def	 	true
battles_description_wh2_main_siege_city_f_hef	 	true
battles_description_wh2_main_siege_city_c_def	 	true
battles_description_wh2_main_siege_city_b_def	 	true
battles_description_wh2_main_siege_city_m_def	 	true
battles_description_wh2_main_siege_city_n_def	 	true
battles_description_wh2_main_siege_city_n_hef	 	true
battles_description_wh2_main_siege_city_h_hef	 	true
battles_localised_name_wh2_qb_isle_of_the_crimson_skull	Isle of the Crimson Skull	true
battles_description_wh2_qb_tower_of_hoeth	 	true
battles_description_def_desert_hills_infield_a_2	 	true
battles_localised_name_wh_dlc05_wef_qb_silver_spire	The Silver Spire	true
battles_description_wh2_qb_dlc09_charnel_valley	 	true
battles_description_wh2_dlc09_tmb_desert_infield_01_03	.	true
battles_description_wh2_dlc09_tmb_desert_infield_02_03	.	true
battles_description_wh2_dlc09_tmb_desert_infield_04_03	.	true
battles_description_wh2_dlc09_tmb_desert_infield_01_02	.	true
battles_description_wh2_dlc09_tmb_desert_infield_02_02	.	true
battles_description_wh2_dlc09_tmb_desert_infield_03_02	.	true
battles_description_wh2_dlc09_tmb_desert_infield_04_02	.	true
battles_description_wh2_dlc09_tmb_desert_infield_01_01	.	true
battles_description_wh2_dlc09_tmb_desert_infield_02_01	.	true
battles_description_wh2_dlc09_tmb_desert_infield_03_01	.	true
battles_description_wh2_dlc09_tmb_desert_infield_04_01	.	true
battles_description_wh2_dlc09_tmb_desert_infield_01_04	.	true
battles_description_wh2_dlc09_tmb_desert_infield_02_04	.	true
battles_localised_name_wh_mp_crossroads	MP Crossroads	true
battles_description_wh_main_qb_qb_grimminhagen_classic	 	true
battles_description_wh_qb_dlc08_wintertooth_crown	 	true
battles_description_wh_main_qb_qb_glacial_lake	 	true
battles_description_wh_main_qb_qb_leitziger_ford	 	true
battles_localised_name_def_pet_forest_infield_a_3	The Ember Glades	true
battles_description_lzd_coast_infield_a_1	 	true
battles_description_lzd_coast_infield_a_3	 	true
battles_description_lzd_coast_infield_a_2	 	true
battles_description_lzd_coast_infield_a_5	 	true
battles_description_def_coast_infield_a_3	 	true
battles_description_def_coast_infield_a_4	 	true
battles_description_wh2_main_chokepoint_norsca_river	 	true
battles_localised_name_wh_main_mp_eschen	Eschen	true
battles_description_wh2_dlc11_cst_island_3	 	true
battles_description_wh2_dlc11_cst_island_2	 	true
battles_description_wh2_dlc11_cst_island_1	 	true
battles_localised_name_def_pet_hills_infield_a_3	Rackdo Ridge	true
battles_description_wh_main_dwarfs_intro	 	true
battles_localised_name_wh2_ult_coast_a_MP	wh2_ult_coast_a_MP	true
battles_description_wh2_qb_dlc11_cylostra_shifting_isles_snowy	 	true
battles_description_wh_main_qb_qb_grimminhagen	 	true
battles_description_wh2_dlc12_qb_ikit_claw_storm_daemon	 	true
battles_description_wh2_main_chokepoint_badlands_chasm	 	true
battles_description_wh2_main_chokepoint_badlands_mountain_pass	 	true
battles_localised_name_wh_dlc05_wef_qb_the_ashenhall	The Ashenhall	true
battles_description_def_desert_dunes_infield_a_2	 	true
battles_description_def_desert_lakes_infield_a_3	 	true
battles_description_wh_main_qb_qb_marbads_tomb	 	true
battles_description_def_desert_ravine_infield_a_2	 	true
battles_description_wh_main_qb_qb_lost_vault_of_king_lunn	 	true
battles_description_wh_main_mp_galbaraz	 	true
battles_localised_name_wh_dlc03_qb_qb_shadow_forest	Shadow Forest	true
battles_localised_name_def_pet_ravine_infield_a_2	Doom Reach	true
battles_localised_name_def_pet_ravine_infield_a_4	The Ash Plains	true
battles_localised_name_wh2_ult_hills_a_MP	wh2_ult_hills_a_MP	true
battles_description_lzd_lakes_infield_a_4_ambush	 	true
battles_description_wh_main_qb_qb_bloodpine_woods_ambush	 	true
battles_description_wh2_main_ffa_troll_country	 	true
battles_description_wh_main_qb_qb_barrier_idols	 	true
battles_description_def_desert_plains_infield_a_4	 	true
battles_description_wh_main_qb_qb_pillar_of_bone	 	true
battles_localised_name_wh_main_qb_qb_marbads_tomb_ambush	Marbad's Tomb	true
battles_description_wh2_dlc12_island_tropical_01	.	true
battles_description_wh2_dlc12_island_tropical_03	.	true
battles_description_wh2_dlc12_island_tropical_02	.	true
battles_localised_name_wh2_dlc12_qb_tehenhauin_plaque_of_sotek	Plaque of Sotek	true
battles_description_wh2_main_chokepoint_northern_mountain_pass	 	true
battles_localised_name_wh_dlc05_wef_forest_path_b	Nexus of the Oak	true
battles_localised_name_wh_dlc05_wef_forest_path_a	Passages of the Asrai	true
battles_localised_name_wh2_qb_vauls_anvil	Vaul's Anvil	true
battles_description_def_hills_infield_a_4_ambush	 	true
battles_localised_name_wh2_dlc12_island_grassy_01	Eastern Straits Isle (Inland)	true
battles_localised_name_wh2_dlc12_island_grassy_02	Eastern Straits Isle (South)	true
battles_localised_name_wh2_dlc12_island_grassy_03	Eastern Straits Isle (North)	true
battles_localised_name_wh_main_qb_qb_stir_river	Stir River	true
battles_localised_name_wh_main_mp_norden	Norden	true
battles_localised_name_def_mtn_pass_infield_a_3	Spite Reach Pass	true
battles_localised_name_def_mtn_pass_infield_a_1	Iron Mountain Pass	true
battles_localised_name_def_nor_river_infield_a_3	The Chill Flow	true
battles_description_wh2_main_chokepoint_sylvania_river	 	true
battles_localised_name_wh_mp_alpine_ridge	MP Alpine Ridge	true
battles_description_wh2_qb_dlc09_staff_of_nagash	 	true
battles_localised_name_wh2_main_chokepoint_generic_mountain_pass	Black Mountain Side	true
battles_localised_name_wh2_dlc12_island_snowy_02	Sea of Chaos Isle (South)	true
battles_localised_name_wh2_dlc12_island_snowy_03	Sea of Chaos Isle (East)	true
battles_localised_name_wh2_dlc12_island_snowy_01	Sea of Chaos Isle (North)	true
battles_description_wh2_qb_dlc09_pack_ice_bay	 	true
battles_localised_name_wh_mp_forest_ridge	MP Heorot Ridge	true
battles_description_wh2_main_chokepoint_norsca_chasm	 	true
battles_localised_name_wh2_qb_dlc11_cst_noctilus_desert	The Moondial	true
battles_localised_name_wh2_main_unfortified_hef_a	Tor Dranil	true
battles_localised_name_wh2_main_unfortified_lzd_d	The Golden Colossus	true
battles_localised_name_wh2_main_unfortified_hef_c	Tower of the Stars	true
battles_localised_name_wh2_main_unfortified_hef_b	Evershale	true
battles_localised_name_wh2_main_unfortified_lzd_a	Monument of the Sun	true
battles_localised_name_wh2_main_unfortified_hef_d	Dawn's Light	true
battles_localised_name_wh2_main_unfortified_lzd_c	Qu'ittax	true
battles_localised_name_wh2_main_unfortified_lzd_b	Avenue of Gold	true
battles_localised_name_wh2_main_unfortified_def_d	Ice Rock Gorge	true
battles_localised_name_wh2_main_unfortified_def_a	Slaver's Point	true
battles_localised_name_wh2_main_unfortified_def_c	Titan Peak	true
battles_description_wh2_qb_warp_shard_armour	 	true
battles_localised_name_wh2_main_unfortified_def_b	Ironspike	true
battles_localised_name_wh2_main_unfortified_skv_b	Scrag Hole	true
battles_localised_name_wh2_main_unfortified_skv_c	Yuatek	true
battles_localised_name_wh2_main_unfortified_skv_a	Altar of the Horned Rat	true
battles_description_def_desert_dunes_infield_a_4_ambush	 	true
battles_localised_name_wh_dlc05_wef_qb_battle_of_the_cairns	Battle of the Cairns	true
battles_description_wh_main_qb_qb_black_fire_pass	 	true
battles_description_wh_main_qb_qb_cliff_of_beasts	 	true
battles_description_wh_main_qb_qb_central_chaos_wastes	 	true
battles_localised_name_def_nor_ravine_infield_a_1	The Crack of Karkan	true
battles_localised_name_wh2_dlc11_cst_qb_harkon	Slann Gold	true
battles_description_ult_lakes_infield_a_2	 	true
battles_description_ult_lakes_infield_a_3	 	true
battles_description_lzd_river_infield_a_2	 	true
battles_description_def_river_infield_a_2	 	true
battles_description_lzd_lakes_infield_a_2	 	true
battles_description_lzd_lakes_infield_a_5	 	true
battles_description_ult_river_infield_a_2	 	true
battles_description_wh_main_qb_qb_bloodpine_woods	 	true
battles_description_lzd_river_infield_a_1_ambush	 	true
battles_description_wh2_qb_dlc11_cylostra_shifting_isles	 	true
battles_description_wh_main_empire_intro	 	true
battles_description_def_bleak_river_infield_a_3	 	true
battles_description_def_bleak_river_infield_a_5	 	true
battles_localised_name_wh2_qb_dlc11_lokhir_black_ark	Black Ark	true
battles_description_wh_dlc03_bst_beast_ambush_02	 	true
battles_description_wh_dlc03_bst_beast_ambush_03	 	true
battles_description_wh_dlc03_bst_beast_ambush_01	 	true
battles_localised_name_wh2_dlc12_island_desert_02	Bay of Corsairs Isle (South)	true
battles_localised_name_wh2_dlc12_island_desert_03	Bay of Corsairs Isle (North)	true
battles_localised_name_wh2_dlc12_island_desert_01	Bay of Corsairs Isle (Inland)	true
battles_localised_name_def_nor_coast_infield_a_1	Shagrath Strand	true
battles_localised_name_wh2_qb_caverns_of_the_great_bat	Caverns of the Great Bat	true
battles_localised_name_wh2_qb_dlc09_black_pyramid	The Black Pyramid	true
battles_description_wh_dlc05_wef_qb_spear_of_kurnous	 	true
battles_localised_name_def_mtn_pass_infield_a_2_ambush	Ice Rock Gorge	true
battles_description_wh2_mp_shrine_of_khaine_01_land	 	true
battles_description_wh2_qb_mortuary_of_tzulaqua	 	true
battles_localised_name_wh_dlc04_qb_qb_altdorf_outskirt	Altdorf Outskirts	true
battles_description_wh2_qb_dlc11_cst_noctilus	.	true
battles_description_wh_main_vampire_counts_intro	 	true
battles_description_wh2_main_chokepoint_lzd_lustria_mountain_pass	 	true
battles_description_wh2_main_chokepoint_northern_river	 	true
battles_localised_name_wh_dlc04_qb_qb_mordheim_ruin	The Void of Hel Fenn	true
battles_localised_name_wh_main_qb_qb_fall_of_man	Fall of Man	true
battles_description_wh2_qb_dlc11_cylostra_shifting_isles_rocky	 	true
battles_description_ult_hills_infield_a_3	 	true
battles_description_wh2_dlc10_qb_alarielle_star_of_avelorn	 	true
battles_localised_name_ult_mtn_pass_infield_a_2	Tor Gard	true
battles_localised_name_wh2_dlc12_island_rocky_02	Bleak Coast Isle (North)	true
battles_localised_name_wh2_dlc12_island_rocky_03	Bleak Coast Isle (South)	true
battles_localised_name_wh2_dlc12_island_rocky_01	Bleak Coast Isle (Inland)	true
battles_description_lzd_swamp_infield_a_3	 	true
battles_description_lzd_swamp_infield_a_2	 	true
battles_localised_name_def_nor_forest_infield_a_3	Deadwood	true
battles_description_wh2_main_chokepoint_badlands_river	 	true
battles_localised_name_wh_main_qb_qb_ancient_dragon_cave	Ancient Dragon Cave	true
battles_description_wh_main_mp_languille	 	true
battles_description_wh_main_mp_waldenhof	 	true
battles_description_wh_main_mp_volksgrad	 	true
battles_localised_name_wh2_main_chokepoint_badlands_river	Blight Water	true
battles_localised_name_wh2_dlc12_qb_tiktaqto_mask_of_heavens	Mask of Heavens	true
battles_description_def_nor_forest_infield_a_3	 	true
battles_localised_name_wh2_main_chokepoint_ult_forest_river	Dappled Flow	true
battles_localised_name_wh2_dlc10_qb_alarielle_star_of_avelorn	Star of Avelorn	true
battles_description_wh_main_mp_karag_dron	 	true
battles_description_wh_dlc05_wef_qb_night_glens	 	true
battles_description_wh_main_qb_qb_hel_fenn_ambush	 	true
battles_description_wh2_dlc11_cst_island_3_tombking	.	true
battles_description_wh_main_qb_qb_northern_chaos_wastes	 	true
battles_description_wh_main_qb_qb_southern_chaos_wastes	 	true
battles_description_wh2_dlc09_unfortified_tmb_a	 	true
battles_description_wh2_dlc09_unfortified_tmb_b	 	true
battles_description_wh2_dlc09_unfortified_tmb_c	 	true
battles_description_wh2_dlc09_unfortified_tmb_d	 	true
battles_description_wh2_dlc09_unfortified_tmb_e	 	true
battles_localised_name_wh2_qb_dlc11_cylostra_shifting_isles_rocky	Shifting Isles Rocky	true
battles_description_wh2_pro05_mp_steps_of_isha_03	 	true
battles_description_wh2_pro05_mp_steps_of_isha_02	 	true
battles_description_wh2_pro05_mp_steps_of_isha_01	 	true
battles_description_wh2_pro05_mp_steps_of_isha_04	 	true
battles_localised_name_wh2_main_chokepoint_northern_river	Bonechill	true
battles_localised_name_wh2_main_chokepoint_def_chasm_b	Ironspike Gorge	true
battles_localised_name_wh2_main_siege_city_h_lzd	Xlanhuapec - Lizardmen	true
battles_localised_name_wh2_main_siege_city_m_lzd	Itza - Lizardmen	true
battles_localised_name_wh2_main_siege_city_n_lzd	Chotec - Lizardmen	true
battles_localised_name_wh2_main_siege_city_b_lzd	Tlaxtlan - Lizardmen	true
battles_localised_name_wh2_main_siege_city_c_lzd	Tlax - Lizardmen	true
battles_localised_name_wh2_main_siege_city_d_lzd	Hexoatl - Lizardmen	true
battles_localised_name_wh2_main_siege_city_f_lzd	Macu Peaks - Lizardmen	true
battles_localised_name_wh2_main_siege_city_p_lzd	Temple of Skulls - Lizardmen	true
battles_localised_name_wh2_main_siege_city_q_lzd	Marks of the Old Ones - Lizardmen	true
battles_description_wh2_qb_dlc09_pits_of_zardok	 	true
battles_localised_name_wh_main_mp_praag	Praag	true
battles_description_wh2_qb_dlc09_black_pyramid	 	true
battles_localised_name_wh2_main_chokepoint_lzd_lustria_river_b	Amaxon Plain	true
battles_description_wh2_dlc12_island_desert_02	.	true
battles_description_wh2_dlc12_island_desert_03	.	true
battles_description_wh2_dlc12_island_desert_01	.	true
battles_localised_name_wh2_main_chokepoint_blood_river_valley_river	Blood River	true
battles_description_def_desert_ravine_infield_a_1_ambush	 	true
battles_localised_name_wh2_main_chokepoint_badlands_river_b	Blind River	true
battles_localised_name_wh2_main_chokepoint_northern_river_b	Frigid Ford	true
battles_localised_name_wh2_main_siege_city_h_dwf	Karak Zorn - Dwarfs	true
battles_localised_name_wh2_dlc11_cst_island_1_rocky	The Maruka Isles	true
battles_localised_name_wh2_dlc11_cst_island_2_rocky	The Ironfrost Isles (Rock)	true
battles_localised_name_wh2_dlc11_cst_island_3_rocky	The Dragon Isles (Rock)	true
battles_description_wh_main_qb_qb_estalian_tomb	 	true
battles_localised_name_wh2_qb_dlc11_cst_final_battle	Battle of the Eternal Tides 	true
battles_description_wh2_final_battle	 	true
battles_description_wh2_main_minor_settlement_fortress_gates	 	true
battles_localised_name_wh_qb_dlc08_sword_of_torgald	Sword of Torgald	true
battles_localised_name_wh2_dlc11_cst_island_2_grassy	The Ironfrost Isles (Grass)	true
battles_localised_name_wh2_qb_altar_of_ultimate_darkness	Altar of Ultimate Darkness	true
battles_description_wh_main_qb_qb_golden_monolith	 	true
battles_description_wh2_qb_fallen_gates	 	true
battles_description_def_nor_ravine_infield_a_1	 	true
battles_localised_name_wh_main_qb_qb_central_chaos_wastes	Central Chaos Wastes	true
battles_description_wh2_qb_dlc11_cylostra_shifting_isles_desert	 	true
battles_description_wh_main_mp_dok_karaz	 	true
battles_localised_name_wh2_dlc11_cst_island_1_desert	The Glass Isles (Desert)	true
battles_localised_name_wh2_dlc11_cst_island_3_desert	The Dragon Isles	true
battles_description_wh_main_mp_gor_gazan	 	true
battles_localised_name_wh_main_qb_qb_blackfire_pass_v2	Mouth of the Pass	true
battles_description_wh2_main_unfortified_hef_a	 	true
battles_localised_name_wh_main_siege_city_c_emp	Averheim - Empire	true
battles_localised_name_wh_main_siege_city_c_vmp	Erengrad - Vampire Counts	true
battles_description_wh2_main_unfortified_lzd_d	 	true
battles_localised_name_wh_main_siege_city_b_emp	Kislev - Empire	true
battles_localised_name_wh_main_siege_city_b_vmp	Castle Templehof - Vampire Counts	true
battles_description_wh2_main_unfortified_hef_c	 	true
battles_localised_name_wh_main_siege_city_a_emp	Bechafen - Empire	true
battles_localised_name_wh_main_siege_city_a_vmp	Castle Drakenhof - Vampire Counts	true
battles_description_wh2_main_unfortified_hef_b	 	true
battles_description_wh2_main_unfortified_lzd_a	 	true
battles_localised_name_wh_main_siege_city_g_emp	Hergig - Empire	true
battles_localised_name_wh_main_siege_city_g_vmp	Salzenmund - Vampire Counts	true
battles_description_wh2_main_unfortified_hef_d	 	true
battles_localised_name_wh_main_siege_city_f_emp	Fort Ostrosk - Empire	true
battles_localised_name_wh_main_siege_city_f_vmp	Talabheim - Vampire Counts	true
battles_description_wh2_main_unfortified_lzd_c	 	true
battles_localised_name_wh_main_siege_city_e_emp	Altdorf - Empire	true
battles_localised_name_wh_main_siege_city_e_vmp	Wolfenburg - Vampire Counts	true
battles_description_wh2_main_unfortified_lzd_b	 	true
battles_localised_name_wh_main_siege_city_d_emp	Akendorf - Empire	true
battles_localised_name_wh_main_siege_city_d_vmp	Marienburg - Vampire Counts	true
battles_description_wh2_main_unfortified_def_d	 	true
battles_description_wh2_main_unfortified_def_a	 	true
battles_description_wh2_main_unfortified_def_c	 	true
battles_description_wh2_main_unfortified_def_b	 	true
battles_description_wh2_main_unfortified_skv_b	 	true
battles_description_wh2_main_unfortified_skv_c	 	true
battles_description_wh2_main_unfortified_skv_a	 	true
battles_description_wh2_qb_isle_of_the_crimson_skull	 	true
battles_localised_name_wh2_qb_dlc12_lord_kroak	Lord Kroak's Temple	true
battles_description_wh_mp_forest_ridge	 	true
battles_localised_name_wh2_dlc10_qb_alith_anar_the_moon_bow	The Moonbow	true
battles_description_wh2_main_chokepoint_southland_river	 	true
battles_description_wh2_dlc09_tmb_desert_infield_01_04_ambush	.	true
battles_description_wh2_dlc09_tmb_desert_infield_02_01_ambush	.	true
battles_description_wh2_dlc11_cst_island_galleons_graveyard_2	.	true
battles_description_wh2_dlc11_cst_island_galleons_graveyard_0	.	true
battles_description_wh2_dlc11_cst_island_galleons_graveyard_1	.	true
battles_localised_name_wh_main_mp_schwartzhafen	Schwartzhafen	true
battles_localised_name_wh2_qb_dlc11_cst_noctilus_rocky	Captain Roth’s Moondial rocky	true
battles_localised_name_wh_main_mp_karak_bhufdar	Karak Bhufdar	true
battles_description_wh_main_mp_castle_drakenhof	 	true
battles_description_wh_mp_alpine_ridge	 	true
battles_description_wh2_main_chokepoint_southland_river_b	 	true
battles_description_wh2_main_chokepoint_def_chasm	 	true
battles_localised_name_wh2_main_chokepoint_sylvania_river	Corpse Run	true
battles_description_def_bleak_forest_infield_a_2	 	true
battles_localised_name_wh2_mp_ffa_05_3	Watcher's Peak	true
battles_localised_name_wh2_mp_ffa_05_2	Gilgalion's Rest	true
battles_localised_name_wh2_mp_ffa_05_1	Moonlight Ridge	true
battles_localised_name_wh2_mp_ffa_05_4	Woodland Ravine	true
battles_description_wh2_dlc12_island_grassy_01	.	true
battles_description_wh2_dlc12_island_grassy_02	.	true
battles_description_wh2_dlc12_island_grassy_03	.	true
battles_localised_name_wh2_main_chokepoint_ult_plains_river	Finuval Flood	true
battles_description_wh_dlc05_wef_forest_path_b	 	true
battles_description_wh_dlc05_wef_forest_path_a	 	true
battles_localised_name_wh_main_qb_qb_high_pass	High Pass	true
battles_description_wh2_qb_vauls_anvil	 	true
battles_description_wh2_dlc11_qb_skjold	 	true
battles_localised_name_wh2_main_chokepoint_northern_mountain_pass	Bladewind Pass	true
battles_localised_name_wh2_main_siege_city_p_emp	Port Reaver - Empire	true
battles_localised_name_wh_main_qb_qb_la_maisontaal_abbey	La Maisontaal Abbey	true
battles_description_wh2_main_subterranean_a_skv	 	true
battles_description_wh2_main_subterranean_b_skv	 	true
battles_description_wh2_main_subterranean_c_skv	 	true
battles_description_wh2_main_chokepoint_grassland_river	 	true
battles_localised_name_wh_main_siege_city_g_brt	Castle Carcassonne - Bretonnia	true
battles_localised_name_wh_main_siege_city_f_brt	Parravon - Bretonnia	true
battles_localised_name_wh_main_siege_city_e_brt	Castle Bastonne - Bretonnia	true
battles_localised_name_wh_main_siege_city_d_brt	Bordeleaux - Bretonnia	true
battles_localised_name_wh_main_siege_city_c_brt	Lyonesse - Bretonnia	true
battles_localised_name_wh_main_siege_city_b_brt	Couronne - Bretonnia	true
battles_localised_name_wh_main_siege_city_a_brt	Castle Artois - Bretonnia	true
battles_localised_name_wh2_qb_dlc11_cst_noctilus_snowy	Captain Roth’s Moondial snowy	true
battles_localised_name_wh_main_siege_city_e_grn	Karak Azgal - Greenskins	true
battles_localised_name_wh_main_siege_city_d_grn	Galbaraz - Greenskins	true
battles_localised_name_wh_main_siege_city_g_grn	Karak Ungor - Greenskins	true
battles_localised_name_wh_main_siege_city_f_grn	Karak Eight Peaks - Greenskins	true
battles_localised_name_wh_main_siege_city_a_grn	Mount Gunbad - Greenskins	true
battles_localised_name_wh_main_siege_city_c_grn	Ekrund - Greenskins	true
battles_localised_name_wh_main_siege_city_b_grn	Karak Azul - Greenskins	true
battles_localised_name_wh2_main_ffa_troll_country	Troll Country	true
battles_description_wh_main_qb_qb_broken_leg_gully_ambush	 	true
battles_description_wh2_ult_hills_a_MP	 	true
battles_localised_name_wh2_main_siege_city_h_skv	Skavenblight - Skaven	true
battles_localised_name_wh2_main_siege_city_m_skv	Ruins - Skaven	true
battles_localised_name_wh2_main_siege_city_e_skv	Hellpit - Skaven	true
battles_localised_name_wh2_dlc11_cst_island_1_snowy	The Glass Isles (Snow)	true
battles_localised_name_wh2_dlc11_cst_island_2_snowy	The Marthenil Archipelago	true
battles_localised_name_wh2_dlc11_cst_island_3_snowy	The Dragon Isles (Snow)	true
battles_description_def_pet_ravine_infield_a_2	 	true
battles_description_def_pet_ravine_infield_a_4	 	true
battles_localised_name_wh_main_qb_qb_shrine_of_ill_omen	Shrine Of Ill Omen	true
battles_description_wh_dlc05_wef_qb_essence_of_chaos	 	true
battles_localised_name_wh2_main_chokepoint_def_grassland_river	The Black Flood	true
battles_localised_name_wh_main_qb_qb_marbads_tomb	Marbad's Tomb	true
battles_localised_name_wh_main_siege_city_e_dwf	Zhufbar - Dwarfs	true
battles_localised_name_wh_main_siege_city_d_dwf	Karak Kadrin - Dwarfs	true
battles_localised_name_wh_main_siege_city_g_dwf	Karak Ziflin - Dwarfs	true
battles_localised_name_wh_main_siege_city_f_dwf	Karak Izor - Dwarfs	true
battles_localised_name_wh_main_siege_city_a_dwf	Karak Norn - Dwarfs	true
battles_localised_name_wh_main_siege_city_c_dwf	Karak Hirn - Dwarfs	true
battles_localised_name_wh_main_siege_city_b_dwf	Barak Varr - Dwarfs	true
battles_description_def_bleak_plains_infield_a_2_ambush	 	true
battles_localised_name_wh2_main_chokepoint_badlands_mountain_pass	Misty Mountain Gorge	true
battles_description_wh2_main_chokepoint_grassland_river_b	 	true
battles_localised_name_wh_dlc04_qb_qb_warpstone_mine	Warpstone Mine	true
battles_localised_name_wh2_main_chokepoint_badlands_chasm	Deff Gorge	true
battles_description_wh2_main_chokepoint_southland_chasm	 	true
battles_localised_name_wh2_qb_dlc11_cylostra_shifting_isles_snowy	Shifting Isles Snowy	true
battles_localised_name_wh_main_qb_qb_grimminhagen	Grimminhagen	true
battles_description_wh2_main_chokepoint_southland_mountain_pass	 	true
battles_description_wh2_ult_coast_a_MP	 	true
battles_localised_name_wh_main_qb_qb_death_pass	Death Pass	true
battles_localised_name_wh_main_mp_bjornlings_gathering	Bjornling's Gathering	true
battles_description_wh_main_qb_qb_mushroom_cave	 	true
battles_localised_name_wh_mp_peak_pass	MP Peak Pass	true
battles_localised_name_wh2_dlc11_cst_island_3	The Dragon Isles (Grass)	true
battles_localised_name_wh2_dlc11_cst_island_2	The Ironfrost Isles (Desert)	true
battles_localised_name_wh2_dlc11_cst_island_1	The Glass Isles (Grass)	true
battles_description_wh2_qb_gouger_gully	 	true
battles_localised_name_wh2_main_siege_city_h_hef	Tor Anroc - High Elves	true
battles_localised_name_wh2_main_siege_city_n_def	Naggarond - Dark Elves	true
battles_localised_name_wh2_main_siege_city_n_hef	Tor Sethai - High Elves	true
battles_localised_name_wh2_main_siege_city_m_def	Hag Hall - Dark Elves	true
battles_localised_name_wh2_main_siege_city_b_def	Ancient City of Quintex - Dark Elves	true
battles_localised_name_wh2_main_siege_city_c_def	Arnheim - Dark Elves	true
battles_localised_name_wh2_main_siege_city_f_hef	Tor Elyr - High Elves	true
battles_localised_name_wh2_main_siege_city_d_def	Hag Graef - Dark Elves	true
battles_localised_name_wh2_main_siege_city_e_hef	Gaean Vale - High Elves	true
battles_description_wh_mp_plains	 	true
battles_localised_name_wh2_main_siege_city_r_def	Sulpharets - Dark Elves	true
battles_localised_name_wh2_main_siege_city_r_hef	Port Elistor - High Elves	true
battles_localised_name_wh2_main_siege_city_p_def	Ghrond - Dark Elves	true
battles_localised_name_wh2_main_siege_city_p_hef	Tor Yvresse - High Elves	true
battles_localised_name_wh2_main_siege_city_q_def	Karond Kar - Dark Elves	true
battles_localised_name_wh2_main_siege_city_q_hef	Lothern - High Elves	true
battles_localised_name_wh2_main_chokepoint_lzd_river_a	River Qurveza	true
battles_description_def_bleak_plains_infield_a_4	 	true
battles_localised_name_wh_main_greenskins_intro	The Siege of Iron Rock	true
battles_description_wh_main_qb_qb_troll_country	 	true
battles_description_def_pet_forest_infield_a_3	 	true
battles_localised_name_wh2_dlc10_shadow_forest	Shadow Realm	true
battles_localised_name_wh_main_qb_qb_glacial_lake	Glacial Lake	true
battles_localised_name_wh_main_qb_qb_grimminhagen_classic	Grimminhagen	true
battles_localised_name_wh2_dlc09_tmb_desert_infield_01_03	The Lost Crater	true
battles_localised_name_wh2_dlc09_tmb_desert_infield_02_03	Mortis Wastes	true
battles_localised_name_wh2_dlc09_tmb_desert_infield_04_03	City of Bones	true
battles_localised_name_wh2_dlc09_tmb_desert_infield_01_02	Vulture Ridge	true
battles_localised_name_wh2_dlc09_tmb_desert_infield_02_02	Ash Plains	true
battles_localised_name_wh2_dlc09_tmb_desert_infield_03_02	Plains of the Dead	true
battles_localised_name_wh2_dlc09_tmb_desert_infield_04_02	The Silver Plains	true
battles_localised_name_wh2_dlc09_tmb_desert_infield_01_01	Tomb of the Shifting Sands	true
battles_localised_name_wh2_dlc09_tmb_desert_infield_02_01	 The Desert’s Bounty	true
battles_localised_name_wh2_dlc09_tmb_desert_infield_03_01	Plateau of the Dead	true
battles_localised_name_wh2_dlc09_tmb_desert_infield_04_01	The Bitter Dunes	true
battles_localised_name_wh2_dlc09_tmb_desert_infield_01_04	Valley of Thieves	true
battles_localised_name_wh2_dlc09_tmb_desert_infield_02_04	Spice Dunes	true
battles_description_wh_main_qb_qb_threat_from_the_north	 	true
battles_localised_name_wh2_mp_ffa_03	Lost Temple	true
battles_localised_name_wh2_mp_ffa_02	Warpstone Crater	true
battles_localised_name_wh2_mp_ffa_01	Grove of Slaughter	true
battles_localised_name_wh2_mp_ffa_06	Roq'Ato Pools	true
battles_localised_name_wh2_mp_ffa_04	Desert Canyon	true
battles_description_wh_dlc04_qb_qb_ostermark	 	true
battles_localised_name_wh2_mp_shrine_of_khaine_05_ambush	The Wasteland	true
battles_localised_name_wh2_main_chokepoint_ult_grassland_river	Wind Ripple	true
battles_localised_name_wh_main_qb_qb_halls_of_karak_azul	Halls of Karak Azul	true
