campaign_group_member_criteria_regions_tables	0
member	region
wh2_dlc09_settlement_tmb_great_pyramids_bhagar	wh2_main_shifting_sands_bhagar
wh2_dlc09_settlement_tmb_great_pyramids_black_pyramid	wh2_main_great_mortis_delta_black_pyramid_of_nagash
wh2_dlc09_settlement_tmb_great_pyramids_ka_sabar	wh2_main_shifting_sands_ka-sabar
wh2_dlc09_settlement_tmb_great_pyramids_khemri	wh2_main_land_of_the_dead_khemri
wh2_dlc09_settlement_tmb_great_pyramids_numas	wh2_main_ash_river_numas
wh2_dlc09_settlement_tmb_great_pyramids_quatar	wh2_main_ash_river_quatar
wh2_dlc09_settlement_tmb_great_pyramids_zandri	wh2_main_land_of_the_dead_zandri
wh2_dlc09_vor_settlement_tmb_great_pyramids_bhagar	wh2_main_vor_shifting_sands_bhagar
wh2_dlc09_vor_settlement_tmb_great_pyramids_black_pyramid	wh2_main_vor_great_mortis_delta_black_pyramid_of_nagash
wh2_dlc09_vor_settlement_tmb_great_pyramids_ka_sabar	wh2_main_vor_shifting_sands_ka-sabar
wh2_dlc09_vor_settlement_tmb_great_pyramids_khemri	wh2_main_vor_land_of_the_dead_khemri
wh2_dlc09_vor_settlement_tmb_great_pyramids_numas	wh2_main_vor_ash_river_numas
wh2_dlc09_vor_settlement_tmb_great_pyramids_quatar	wh2_main_vor_ash_river_quatar
wh2_dlc09_vor_settlement_tmb_great_pyramids_zandri	wh2_main_vor_land_of_the_dead_zandri
wh2_main_gc_abandoned_regions_wh2_main_def_dark_elves_wh2_main_deadwood_shagrath	wh2_main_deadwood_shagrath
wh2_main_gc_abandoned_regions_wh2_main_def_dark_elves_wh2_main_deadwood_the_frozen_city	wh2_main_deadwood_the_frozen_city
wh2_main_gc_abandoned_regions_wh2_main_def_dark_elves_wh2_main_doom_glades_ice_rock_gorge	wh2_main_doom_glades_ice_rock_gorge
wh2_main_gc_abandoned_regions_wh2_main_def_dark_elves_wh2_main_doom_glades_temple_of_addaioth	wh2_main_doom_glades_temple_of_addaioth
wh2_main_gc_abandoned_regions_wh2_main_def_dark_elves_wh2_main_the_black_flood_temple_of_khaine	wh2_main_the_black_flood_temple_of_khaine
wh2_main_gc_abandoned_regions_wh2_main_hef_high_elves_wh2_main_eataine_shrine_of_asuryan	wh2_main_eataine_shrine_of_asuryan
wh2_main_gc_abandoned_regions_wh2_main_hef_high_elves_wh2_main_volcanic_islands_fuming_serpent	wh2_main_volcanic_islands_fuming_serpent
wh2_main_gc_abandoned_regions_wh2_main_lzd_lizardmen_wh2_main_headhunters_jungle_mangrove_coast	wh2_main_headhunters_jungle_mangrove_coast
wh2_main_gc_abandoned_regions_wh2_main_lzd_lizardmen_wh2_main_huahuan_desert_chamber_of_visions	wh2_main_huahuan_desert_chamber_of_visions
wh2_main_gc_abandoned_regions_wh2_main_lzd_lizardmen_wh2_main_isthmus_of_lustria_ziggurat_of_dawn	wh2_main_isthmus_of_lustria_ziggurat_of_dawn
wh2_main_gc_abandoned_regions_wh2_main_lzd_lizardmen_wh2_main_jungles_of_green_mists_spektazuma	wh2_main_jungles_of_green_mists_spektazuma
wh2_main_gc_abandoned_regions_wh2_main_lzd_lizardmen_wh2_main_jungles_of_green_mists_wellsprings_of_eternity	wh2_main_jungles_of_green_mists_wellsprings_of_eternity
wh2_main_gc_abandoned_regions_wh2_main_lzd_lizardmen_wh2_main_kingdom_of_beasts_serpent_coast	wh2_main_kingdom_of_beasts_serpent_coast
wh2_main_gc_abandoned_regions_wh2_main_lzd_lizardmen_wh2_main_kingdom_of_beasts_the_cursed_jungle	wh2_main_kingdom_of_beasts_the_cursed_jungle
wh2_main_gc_abandoned_regions_wh2_main_lzd_lizardmen_wh2_main_northern_great_jungle_chaqua	wh2_main_northern_great_jungle_chaqua
wh2_main_gc_abandoned_regions_wh2_main_lzd_lizardmen_wh2_main_northern_great_jungle_temple_of_tlencan	wh2_main_northern_great_jungle_temple_of_tlencan
wh2_main_gc_abandoned_regions_wh2_main_lzd_lizardmen_wh2_main_northern_great_jungle_xahutec	wh2_main_northern_great_jungle_xahutec
wh2_main_gc_abandoned_regions_wh2_main_lzd_lizardmen_wh2_main_northern_jungle_of_pahualaxa_macu_peaks	wh2_main_northern_jungle_of_pahualaxa_macu_peaks
wh2_main_gc_abandoned_regions_wh2_main_lzd_lizardmen_wh2_main_northern_jungle_of_pahualaxa_shrine_of_sotek	wh2_main_northern_jungle_of_pahualaxa_shrine_of_sotek
wh2_main_gc_abandoned_regions_wh2_main_lzd_lizardmen_wh2_main_southern_great_jungle_axlotl	wh2_main_southern_great_jungle_axlotl
wh2_main_gc_abandoned_regions_wh2_main_lzd_lizardmen_wh2_main_southern_great_jungle_subatuun	wh2_main_southern_great_jungle_subatuun
wh2_main_gc_abandoned_regions_wh2_main_lzd_lizardmen_wh2_main_southern_jungle_of_pahualaxa_monument_of_the_moon	wh2_main_southern_jungle_of_pahualaxa_monument_of_the_moon
wh2_main_gc_abandoned_regions_wh2_main_lzd_lizardmen_wh2_main_southern_jungle_of_pahualaxa_pahuax	wh2_main_southern_jungle_of_pahualaxa_pahuax
wh2_main_gc_abandoned_regions_wh2_main_lzd_lizardmen_wh2_main_the_creeping_jungle_temple_of_kara	wh2_main_the_creeping_jungle_temple_of_kara
wh2_main_gc_abandoned_regions_wh2_main_lzd_lizardmen_wh2_main_the_creeping_jungle_tlanxla	wh2_main_the_creeping_jungle_tlanxla
wh2_main_gc_abandoned_regions_wh_main_brt_bretonnia_wh2_main_great_desert_of_araby_el-kalabad	wh2_main_great_desert_of_araby_el-kalabad
wh2_main_gc_abandoned_regions_wh_main_dwf_dwarfs_wh2_main_southlands_worlds_edge_mountains_lost_plateau	wh2_main_southlands_worlds_edge_mountains_lost_plateau
wh2_main_gc_abandoned_regions_wh_main_dwf_dwarfs_wh2_main_spine_of_sotek_hualotal	wh2_main_spine_of_sotek_hualotal
wh2_main_gc_abandoned_regions_wh_main_dwf_dwarfs_wh2_main_spine_of_sotek_mine_of_the_bearded_skulls	wh2_main_spine_of_sotek_mine_of_the_bearded_skulls
wh2_main_gc_abandoned_regions_wh_main_dwf_dwarfs_wh2_main_spine_of_sotek_monument_of_izzatal	wh2_main_spine_of_sotek_monument_of_izzatal
wh2_main_gc_abandoned_regions_wh_main_vmp_vampire_counts_wh2_main_ash_river_numas	wh2_main_ash_river_numas
wh2_main_gc_abandoned_regions_wh_main_vmp_vampire_counts_wh2_main_crater_of_the_walking_dead_doom_glade	wh2_main_crater_of_the_walking_dead_doom_glade
wh2_main_gc_abandoned_regions_wh_main_vmp_vampire_counts_wh2_main_devils_backbone_lybaras	wh2_main_devils_backbone_lybaras
wh2_main_gc_abandoned_regions_wh_main_vmp_vampire_counts_wh2_main_great_desert_of_araby_bel_aliad	wh2_main_great_desert_of_araby_bel_aliad
wh2_main_gc_abandoned_regions_wh_main_vmp_vampire_counts_wh2_main_shifting_sands_antoch	wh2_main_shifting_sands_antoch
wh2_main_tunnelling_excluded_regions_avelorn_evershale	wh2_main_avelorn_evershale
wh2_main_tunnelling_excluded_regions_avelorn_gaean_vale	wh2_main_avelorn_gaean_vale
wh2_main_tunnelling_excluded_regions_avelorn_tor_saroir	wh2_main_avelorn_tor_saroir
wh2_main_tunnelling_excluded_regions_caledor_tor_sethai	wh2_main_caledor_tor_sethai
wh2_main_tunnelling_excluded_regions_caledor_vauls_anvil	wh2_main_caledor_vauls_anvil
wh2_main_tunnelling_excluded_regions_chrace_elisia	wh2_main_chrace_elisia
wh2_main_tunnelling_excluded_regions_chrace_tor_achare	wh2_main_chrace_tor_achare
wh2_main_tunnelling_excluded_regions_cothique_mistnar	wh2_main_cothique_mistnar
wh2_main_tunnelling_excluded_regions_cothique_tor_koruali	wh2_main_cothique_tor_koruali
wh2_main_tunnelling_excluded_regions_eagle_gate	wh2_main_eagle_gate
wh2_main_tunnelling_excluded_regions_eataine_angerrial	wh2_main_eataine_angerrial
wh2_main_tunnelling_excluded_regions_eataine_lothern	wh2_main_eataine_lothern
wh2_main_tunnelling_excluded_regions_eataine_shrine_of_asuryan	wh2_main_eataine_shrine_of_asuryan
wh2_main_tunnelling_excluded_regions_eataine_tower_of_lysean	wh2_main_eataine_tower_of_lysean
wh2_main_tunnelling_excluded_regions_ellyrion_tor_elyr	wh2_main_ellyrion_tor_elyr
wh2_main_tunnelling_excluded_regions_ellyrion_whitefire_tor	wh2_main_ellyrion_whitefire_tor
wh2_main_tunnelling_excluded_regions_griffon_gate	wh2_main_griffon_gate
wh2_main_tunnelling_excluded_regions_nagarythe_shrine_of_khaine	wh2_main_nagarythe_shrine_of_khaine
wh2_main_tunnelling_excluded_regions_nagarythe_tor_anlec	wh2_main_nagarythe_tor_anlec
wh2_main_tunnelling_excluded_regions_nagarythe_tor_dranil	wh2_main_nagarythe_tor_dranil
wh2_main_tunnelling_excluded_regions_phoenix_gate	wh2_main_phoenix_gate
wh2_main_tunnelling_excluded_regions_saphery_port_elistor	wh2_main_saphery_port_elistor
wh2_main_tunnelling_excluded_regions_saphery_tor_finu	wh2_main_saphery_tor_finu
wh2_main_tunnelling_excluded_regions_saphery_tower_of_hoeth	wh2_main_saphery_tower_of_hoeth
wh2_main_tunnelling_excluded_regions_tiranoc_tor_anroc	wh2_main_tiranoc_tor_anroc
wh2_main_tunnelling_excluded_regions_tiranoc_whitepeak	wh2_main_tiranoc_whitepeak
wh2_main_tunnelling_excluded_regions_unicorn_gate	wh2_main_unicorn_gate
wh2_main_tunnelling_excluded_regions_yvresse_elessaeli	wh2_main_yvresse_elessaeli
wh2_main_tunnelling_excluded_regions_yvresse_tor_yvresse	wh2_main_yvresse_tor_yvresse
wh2_main_vor_abandoned_regions_wh2_main_def_dark_elves_wh2_main_vor_ashen_coast_sulpharets	wh2_main_vor_ashen_coast_sulpharets
wh2_main_vor_abandoned_regions_wh2_main_def_dark_elves_wh2_main_vor_deadwood_shagrath	wh2_main_vor_deadwood_shagrath
wh2_main_vor_abandoned_regions_wh2_main_def_dark_elves_wh2_main_vor_deadwood_the_frozen_city	wh2_main_vor_deadwood_the_frozen_city
wh2_main_vor_abandoned_regions_wh2_main_def_dark_elves_wh2_main_vor_grey_guardians_grey_rock_point	wh2_main_vor_grey_guardians_grey_rock_point
wh2_main_vor_abandoned_regions_wh2_main_def_dark_elves_wh2_main_vor_grey_guardians_titan_peak	wh2_main_vor_grey_guardians_titan_peak
wh2_main_vor_abandoned_regions_wh2_main_def_dark_elves_wh2_main_vor_iron_mountains_cragroth_deep	wh2_main_vor_iron_mountains_cragroth_deep
wh2_main_vor_abandoned_regions_wh2_main_def_dark_elves_wh2_main_vor_iron_mountains_rackdo_gorge	wh2_main_vor_iron_mountains_rackdo_gorge
wh2_main_vor_abandoned_regions_wh2_main_def_dark_elves_wh2_main_vor_iron_mountains_shroktak_mount	wh2_main_vor_iron_mountains_shroktak_mount
wh2_main_vor_abandoned_regions_wh2_main_def_dark_elves_wh2_main_vor_iron_peaks_tyrant_peak	wh2_main_vor_ashen_coast_tyrant_peak
wh2_main_vor_abandoned_regions_wh2_main_def_dark_elves_wh2_main_vor_land_of_the_dead_zandri	wh2_main_vor_land_of_the_dead_zandri
wh2_main_vor_abandoned_regions_wh2_main_def_dark_elves_wh2_main_vor_obsidian_peaks_ice_rock_gorge	wh2_main_vor_obsidian_peaks_ice_rock_gorge
wh2_main_vor_abandoned_regions_wh2_main_def_dark_elves_wh2_main_vor_obsidian_peaks_ice_spire	wh2_main_vor_obsidian_peaks_ice_spire
wh2_main_vor_abandoned_regions_wh2_main_def_dark_elves_wh2_main_vor_obsidian_peaks_temple_of_addaioth	wh2_main_vor_obsidian_peaks_temple_of_addaioth
wh2_main_vor_abandoned_regions_wh2_main_def_dark_elves_wh2_main_vor_plain_of_spiders_pits_of_zardok	wh2_main_vor_plain_of_spiders_pits_of_zardok
wh2_main_vor_abandoned_regions_wh2_main_def_dark_elves_wh2_main_vor_shadow_wood_daldrachs_lair	wh2_main_vor_shadow_wood_daldrachs_lair
wh2_main_vor_abandoned_regions_wh2_main_def_dark_elves_wh2_main_vor_the_chill_road_the_great_arena	wh2_main_vor_the_chill_road_the_great_arena
wh2_main_vor_abandoned_regions_wh2_main_def_dark_elves_wh2_main_vor_the_dragon_isles_isle_of_the_crimson_skull	wh2_main_vor_the_dragon_isles_isle_of_the_crimson_skull
wh2_main_vor_abandoned_regions_wh2_main_hef_high_elves_wh2_main_vor_caledor_caledors_repose	wh2_main_vor_caledor_caledors_repose
wh2_main_vor_abandoned_regions_wh2_main_hef_high_elves_wh2_main_vor_eataine_shrine_of_asuryan	wh2_main_vor_eataine_shrine_of_asuryan
wh2_main_vor_abandoned_regions_wh2_main_hef_high_elves_wh2_main_vor_land_of_the_dervishes_elven_ruins	wh2_main_vor_land_of_the_dervishes_elven_ruins
wh2_main_vor_abandoned_regions_wh2_main_hef_high_elves_wh2_main_vor_northern_yvresse_sardenath	wh2_main_vor_northern_yvresse_sardenath
wh2_main_vor_abandoned_regions_wh2_main_hef_high_elves_wh2_main_vor_tiranoc_tor_anroc	wh2_main_vor_tiranoc_tor_anroc
wh2_main_vor_abandoned_regions_wh2_main_lzd_lizardmen_wh2_main_vor_coast_of_squalls_macu_peaks	wh2_main_vor_coast_of_squalls_macu_peaks
wh2_main_vor_abandoned_regions_wh2_main_lzd_lizardmen_wh2_main_vor_coast_of_squalls_monument_of_the_sun	wh2_main_vor_coast_of_squalls_monument_of_the_sun
wh2_main_vor_abandoned_regions_wh2_main_lzd_lizardmen_wh2_main_vor_coast_of_squalls_shrine_of_sotek	wh2_main_vor_coast_of_squalls_shrine_of_sotek
wh2_main_vor_abandoned_regions_wh2_main_lzd_lizardmen_wh2_main_vor_copper_desert_the_forgotten_isles	wh2_main_vor_copper_desert_the_forgotten_isles
wh2_main_vor_abandoned_regions_wh2_main_lzd_lizardmen_wh2_main_vor_culchan_plains_chupayotl	wh2_main_vor_culchan_plains_chupayotl
wh2_main_vor_abandoned_regions_wh2_main_lzd_lizardmen_wh2_main_vor_culchan_plains_kaiax	wh2_main_vor_culchan_plains_kaiax
wh2_main_vor_abandoned_regions_wh2_main_lzd_lizardmen_wh2_main_vor_culchan_plains_xlansec	wh2_main_vor_culchan_plains_xlansec
wh2_main_vor_abandoned_regions_wh2_main_lzd_lizardmen_wh2_main_vor_forest_of_the_viper_fallen_gates	wh2_main_vor_forest_of_the_viper_fallen_gates
wh2_main_vor_abandoned_regions_wh2_main_lzd_lizardmen_wh2_main_vor_jungle_of_pahualaxa_floating_pyramid	wh2_main_vor_jungle_of_pahualaxa_floating_pyramid
wh2_main_vor_abandoned_regions_wh2_main_lzd_lizardmen_wh2_main_vor_jungle_of_pahualaxa_monument_of_the_moon	wh2_main_vor_jungle_of_pahualaxa_monument_of_the_moon
wh2_main_vor_abandoned_regions_wh2_main_lzd_lizardmen_wh2_main_vor_jungle_of_pahualaxa_pahuax	wh2_main_vor_jungle_of_pahualaxa_pahuax
wh2_main_vor_abandoned_regions_wh2_main_lzd_lizardmen_wh2_main_vor_jungles_of_green_mist_pillars_of_unseen_constellations	wh2_main_vor_jungles_of_green_mist_pillars_of_unseen_constellations
wh2_main_vor_abandoned_regions_wh2_main_lzd_lizardmen_wh2_main_vor_kingdom_of_beasts_the_cursed_jungle	wh2_main_vor_kingdom_of_beasts_the_cursed_jungle
wh2_main_vor_abandoned_regions_wh2_main_lzd_lizardmen_wh2_main_vor_mosquito_swamps_xahutec	wh2_main_vor_mosquito_swamps_xahutec
wh2_main_vor_abandoned_regions_wh2_main_lzd_lizardmen_wh2_main_vor_northern_great_jungle_quetza	wh2_main_vor_northern_great_jungle_quetza
wh2_main_vor_abandoned_regions_wh2_main_lzd_lizardmen_wh2_main_vor_northern_great_jungle_quittax	wh2_main_vor_northern_great_jungle_quittax
wh2_main_vor_abandoned_regions_wh2_main_lzd_lizardmen_wh2_main_vor_river_qurveza_axlotl	wh2_main_vor_river_qurveza_axlotl
wh2_main_vor_abandoned_regions_wh2_main_lzd_lizardmen_wh2_main_vor_river_qurveza_mouth_of_qurveza	wh2_main_vor_river_qurveza_mouth_of_qurveza
wh2_main_vor_abandoned_regions_wh2_main_lzd_lizardmen_wh2_main_vor_scorpion_coast_temple_of_tlencan	wh2_main_vor_scorpion_coast_temple_of_tlencan
wh2_main_vor_abandoned_regions_wh2_main_lzd_lizardmen_wh2_main_vor_shifting_mangrove_coastline_tower_of_the_gods	wh2_main_vor_the_red_rivers_golden_tower_of_the_gods
wh2_main_vor_abandoned_regions_wh2_main_lzd_lizardmen_wh2_main_vor_southern_great_jungle_mortuary_of_tzulaqua	wh2_main_vor_southern_great_jungle_mortuary_of_tzulaqua
wh2_main_vor_abandoned_regions_wh2_main_lzd_lizardmen_wh2_main_vor_southern_great_jungle_xhotl	wh2_main_vor_southern_great_jungle_xhotl
wh2_main_vor_abandoned_regions_wh2_main_lzd_lizardmen_wh2_main_vor_southern_jungles_scrag_hole	wh2_main_vor_southern_jungles_scrag_hole
wh2_main_vor_abandoned_regions_wh2_main_lzd_lizardmen_wh2_main_vor_the_creeping_jungle_tlanxla	wh2_main_vor_the_creeping_jungle_tlanxla
wh2_main_vor_abandoned_regions_wh2_main_lzd_lizardmen_wh2_main_vor_the_forbidden_jungle_chamber_of_visions	wh2_main_vor_the_forbidden_jungle_chamber_of_visions
wh2_main_vor_abandoned_regions_wh2_main_lzd_lizardmen_wh2_main_vor_the_jungles_of_the_gods_avenue_of_gold	wh2_main_vor_shifting_mangrove_coastline_temple_avenue_of_gold
wh2_main_vor_abandoned_regions_wh2_main_lzd_lizardmen_wh2_main_vor_the_lost_valleys_the_sentinel_of_time	wh2_main_vor_the_lost_valleys_the_sentinel_of_time
wh2_main_vor_abandoned_regions_wh2_main_lzd_lizardmen_wh2_main_vor_the_turtle_isles_mud_isle	wh2_main_vor_the_turtle_isles_mud_isle
wh2_main_vor_abandoned_regions_wh2_main_lzd_lizardmen_wh2_main_vor_western_jungles_deaths-head_monoliths	wh2_main_vor_western_jungles_deaths-head_monoliths
wh2_main_vor_abandoned_regions_wh2_main_lzd_lizardmen_wh2_main_vor_western_jungles_statues_of_the_gods	wh2_main_vor_western_jungles_statues_of_the_gods
wh2_main_vor_abandoned_regions_wh_main_dwf_dwarfs_wh2_main_vor_central_spine_of_sotek_chiquibol	wh2_main_vor_central_spine_of_sotek_chiquibol
wh2_main_vor_abandoned_regions_wh_main_dwf_dwarfs_wh2_main_vor_northern_spine_of_sotek_cavern_of_the_mlexigaur	wh2_main_vor_northern_spine_of_sotek_cavern_of_the_mlexigaur
wh2_main_vor_abandoned_regions_wh_main_dwf_dwarfs_wh2_main_vor_northern_spine_of_sotek_hualotal	wh2_main_vor_northern_spine_of_sotek_hualotal
wh2_main_vor_abandoned_regions_wh_main_dwf_dwarfs_wh2_main_vor_northern_spine_of_sotek_monument_of_izzatal	wh2_main_vor_northern_spine_of_sotek_monument_of_izzatal
wh2_main_vor_abandoned_regions_wh_main_vmp_vampire_counts_wh2_main_vor_ash_river_numas	wh2_main_vor_ash_river_numas
wh2_main_vor_abandoned_regions_wh_main_vmp_vampire_counts_wh2_main_vor_ash_river_the_salt_plain	wh2_main_vor_ash_river_the_salt_plain
wh2_main_vor_abandoned_regions_wh_main_vmp_vampire_counts_wh2_main_vor_shifting_sands_antoch	wh2_main_vor_shifting_sands_antoch
wh2_main_vor_abandoned_regions_wh_main_vmp_vampire_counts_wh2_main_vor_shifting_sands_plain_of_tuskers	wh2_main_vor_shifting_sands_plain_of_tuskers
wh2_main_vor_abandoned_regions_wh_main_vmp_vampire_counts_wh2_main_vor_the_great_desert_bel_aliad	wh2_main_vor_the_great_desert_bel_aliad
wh2_main_vor_abandoned_regions_wh_main_vmp_vampire_counts_wh2_main_vor_the_vampire_coast_the_star_tower	wh2_main_vor_the_vampire_coast_the_star_tower
wh2_main_vor_tunnelling_excluded_regions_avelorn_evershale	wh2_main_vor_avelorn_evershale
wh2_main_vor_tunnelling_excluded_regions_avelorn_gaean_vale	wh2_main_vor_avelorn_gaean_vale
wh2_main_vor_tunnelling_excluded_regions_avelorn_tor_saroir	wh2_main_vor_avelorn_tor_saroir
wh2_main_vor_tunnelling_excluded_regions_caledor_caledors_repose	wh2_main_vor_caledor_caledors_repose
wh2_main_vor_tunnelling_excluded_regions_caledor_tor_sethai	wh2_main_vor_caledor_tor_sethai
wh2_main_vor_tunnelling_excluded_regions_caledor_vauls_anvil	wh2_main_vor_caledor_vauls_anvil
wh2_main_vor_tunnelling_excluded_regions_chrace_elisia	wh2_main_vor_chrace_elisia
wh2_main_vor_tunnelling_excluded_regions_chrace_tor_achare	wh2_main_vor_chrace_tor_achare
wh2_main_vor_tunnelling_excluded_regions_chrace_tor_gard	wh2_main_vor_chrace_tor_gard
wh2_main_vor_tunnelling_excluded_regions_cothique_mistnar	wh2_main_vor_cothique_mistnar
wh2_main_vor_tunnelling_excluded_regions_cothique_tor_koruali	wh2_main_vor_cothique_tor_koruali
wh2_main_vor_tunnelling_excluded_regions_eagle_gate	wh2_main_vor_eagle_gate
wh2_main_vor_tunnelling_excluded_regions_eataine_angerrial	wh2_main_vor_eataine_angerrial
wh2_main_vor_tunnelling_excluded_regions_eataine_shrine_of_asuryan	wh2_main_vor_eataine_shrine_of_asuryan
wh2_main_vor_tunnelling_excluded_regions_ellyrion_reavers_mark	wh2_main_vor_ellyrion_reavers_mark
wh2_main_vor_tunnelling_excluded_regions_ellyrion_the_arc_span	wh2_main_vor_ellyrion_the_arc_span
wh2_main_vor_tunnelling_excluded_regions_ellyrion_tor_elyr	wh2_main_vor_ellyrion_tor_elyr
wh2_main_vor_tunnelling_excluded_regions_griffon_gate	wh2_main_vor_griffon_gate
wh2_main_vor_tunnelling_excluded_regions_nagarythe_shrine_of_khaine	wh2_main_vor_nagarythe_shrine_of_khaine
wh2_main_vor_tunnelling_excluded_regions_nagarythe_tor_anlec	wh2_main_vor_nagarythe_tor_anlec
wh2_main_vor_tunnelling_excluded_regions_nagarythe_tor_dranil	wh2_main_vor_nagarythe_tor_dranil
wh2_main_vor_tunnelling_excluded_regions_northern_yvresse_sardenath	wh2_main_vor_northern_yvresse_sardenath
wh2_main_vor_tunnelling_excluded_regions_northern_yvresse_tor_yvresse	wh2_main_vor_northern_yvresse_tor_yvresse
wh2_main_vor_tunnelling_excluded_regions_northern_yvresse_tralinia	wh2_main_vor_northern_yvresse_tralinia
wh2_main_vor_tunnelling_excluded_regions_phoenix_gate	wh2_main_vor_phoenix_gate
wh2_main_vor_tunnelling_excluded_regions_saphery_port_elistor	wh2_main_vor_saphery_port_elistor
wh2_main_vor_tunnelling_excluded_regions_saphery_shadow_peak	wh2_main_vor_saphery_shadow_peak
wh2_main_vor_tunnelling_excluded_regions_saphery_tor_finu	wh2_main_vor_saphery_tor_finu
wh2_main_vor_tunnelling_excluded_regions_saphery_tower_of_hoeth	wh2_main_vor_saphery_tower_of_hoeth
wh2_main_vor_tunnelling_excluded_regions_southern_yvresse_cairn_thel	wh2_main_vor_southern_yvresse_cairn_thel
wh2_main_vor_tunnelling_excluded_regions_southern_yvresse_elessaeli	wh2_main_vor_southern_yvresse_elessaeli
wh2_main_vor_tunnelling_excluded_regions_southern_yvresse_shrine_of_loec	wh2_main_vor_southern_yvresse_shrine_of_loec
wh2_main_vor_tunnelling_excluded_regions_straits_of_lothern_glittering_tower	wh2_main_vor_straits_of_lothern_glittering_tower
wh2_main_vor_tunnelling_excluded_regions_straits_of_lothern_lothern	wh2_main_vor_straits_of_lothern_lothern
wh2_main_vor_tunnelling_excluded_regions_straits_of_lothern_tower_of_lysean	wh2_main_vor_straits_of_lothern_tower_of_lysean
wh2_main_vor_tunnelling_excluded_regions_tiranoc_salvation_isle	wh2_main_vor_tiranoc_salvation_isle
wh2_main_vor_tunnelling_excluded_regions_tiranoc_the_high_vale	wh2_main_vor_tiranoc_the_high_vale
wh2_main_vor_tunnelling_excluded_regions_tiranoc_tor_anroc	wh2_main_vor_tiranoc_tor_anroc
wh2_main_vor_tunnelling_excluded_regions_tiranoc_whitepeak	wh2_main_vor_tiranoc_whitepeak
wh2_main_vor_tunnelling_excluded_regions_unicorn_gate	wh2_main_vor_unicorn_gate
wh_occupation_decision_norsca_occupy_wh2_main_aghol_wastelands_fortress_of_the_damned	wh2_main_aghol_wastelands_fortress_of_the_damned
wh_occupation_decision_norsca_occupy_wh2_main_aghol_wastelands_palace_of_princes	wh2_main_aghol_wastelands_palace_of_princes
wh_occupation_decision_norsca_occupy_wh2_main_aghol_wastelands_the_palace_of_ruin	wh2_main_aghol_wastelands_the_palace_of_ruin
wh_occupation_decision_norsca_occupy_wh2_main_albion_albion	wh2_main_albion_albion
wh_occupation_decision_norsca_occupy_wh2_main_avalorn_gaean_vale	wh2_main_avelorn_gaean_vale
wh_occupation_decision_norsca_occupy_wh2_main_avelorn_evershale	wh2_main_avelorn_evershale
wh_occupation_decision_norsca_occupy_wh2_main_chrace_elisia	wh2_main_chrace_elisia
wh_occupation_decision_norsca_occupy_wh2_main_coast_of_araby_al_haikk	wh2_main_coast_of_araby_al_haikk
wh_occupation_decision_norsca_occupy_wh2_main_coast_of_araby_copher	wh2_main_coast_of_araby_copher
wh_occupation_decision_norsca_occupy_wh2_main_cothique_mistnar	wh2_main_cothique_mistnar
wh_occupation_decision_norsca_occupy_wh2_main_cothique_tor_koruali	wh2_main_cothique_tor_koruali
wh_occupation_decision_norsca_occupy_wh2_main_deadwood_nagrar	wh2_main_deadwood_nagrar
wh_occupation_decision_norsca_occupy_wh2_main_deadwood_shagrath	wh2_main_deadwood_shagrath
wh_occupation_decision_norsca_occupy_wh2_main_eataine_angerrial	wh2_main_eataine_angerrial
wh_occupation_decision_norsca_occupy_wh2_main_eataine_lothern	wh2_main_eataine_lothern
wh_occupation_decision_norsca_occupy_wh2_main_ellyrion_whitefire_tor	wh2_main_ellyrion_whitefire_tor
wh_occupation_decision_norsca_occupy_wh2_main_headhunters_jungle_chupayotl	wh2_main_headhunters_jungle_chupayotl
wh_occupation_decision_norsca_occupy_wh2_main_headhunters_jungle_mangrove_coast	wh2_main_headhunters_jungle_mangrove_coast
wh_occupation_decision_norsca_occupy_wh2_main_hell_pit_hell_pit	wh2_main_hell_pit_hell_pit
wh_occupation_decision_norsca_occupy_wh2_main_iron_mountains_naggarond	wh2_main_iron_mountains_naggarond
wh_occupation_decision_norsca_occupy_wh2_main_ironfrost_glacier_dagraks_end	wh2_main_ironfrost_glacier_dagraks_end
wh_occupation_decision_norsca_occupy_wh2_main_ironfrost_glacier_ironfrost	wh2_main_ironfrost_glacier_ironfrost
wh_occupation_decision_norsca_occupy_wh2_main_isthmus_of_lustria_hexoatl	wh2_main_isthmus_of_lustria_hexoatl
wh_occupation_decision_norsca_occupy_wh2_main_isthmus_of_lustria_skeggi	wh2_main_isthmus_of_lustria_skeggi
wh_occupation_decision_norsca_occupy_wh2_main_isthmus_of_lustria_ziggurat_of_dawn	wh2_main_isthmus_of_lustria_ziggurat_of_dawn
wh_occupation_decision_norsca_occupy_wh2_main_land_of_assassins_lashiek	wh2_main_land_of_assassins_lashiek
wh_occupation_decision_norsca_occupy_wh2_main_land_of_assassins_sorcerers_islands	wh2_main_land_of_assassins_sorcerers_islands
wh_occupation_decision_norsca_occupy_wh2_main_land_of_the_dead_khemri	wh2_main_land_of_the_dead_khemri
wh_occupation_decision_norsca_occupy_wh2_main_land_of_the_dead_zandri	wh2_main_land_of_the_dead_zandri
wh_occupation_decision_norsca_occupy_wh2_main_land_of_the_dervishes_plain_of_tuskers	wh2_main_land_of_the_dervishes_plain_of_tuskers
wh_occupation_decision_norsca_occupy_wh2_main_land_of_the_dervishes_sudenburg	wh2_main_land_of_the_dervishes_sudenburg
wh_occupation_decision_norsca_occupy_wh2_main_nagarythe_tor_anlec	wh2_main_nagarythe_tor_anlec
wh_occupation_decision_norsca_occupy_wh2_main_northern_great_jungle_temple_of_tlencan	wh2_main_northern_great_jungle_temple_of_tlencan
wh_occupation_decision_norsca_occupy_wh2_main_northern_jungle_of_pahualaxa_port_reaver	wh2_main_northern_jungle_of_pahualaxa_port_reaver
wh_occupation_decision_norsca_occupy_wh2_main_northern_jungle_of_pahualaxa_swamp_town	wh2_main_northern_jungle_of_pahualaxa_swamp_town
wh_occupation_decision_norsca_occupy_wh2_main_obsidian_peaks_circle_of_destruction	wh2_main_obsidian_peaks_circle_of_destruction
wh_occupation_decision_norsca_occupy_wh2_main_saphery_port_elistor	wh2_main_saphery_port_elistor
wh_occupation_decision_norsca_occupy_wh2_main_sartosa_sartosa	wh2_main_sartosa_sartosa
wh_occupation_decision_norsca_occupy_wh2_main_skavenblight_skavenblight	wh2_main_skavenblight_skavenblight
wh_occupation_decision_norsca_occupy_wh2_main_southern_great_jungle_itza	wh2_main_southern_great_jungle_itza
wh_occupation_decision_norsca_occupy_wh2_main_southern_jungle_of_pahualaxa_monument_of_the_moon	wh2_main_southern_jungle_of_pahualaxa_monument_of_the_moon
wh_occupation_decision_norsca_occupy_wh2_main_southern_jungle_of_pahualaxa_the_high_sentinel	wh2_main_southern_jungle_of_pahualaxa_the_high_sentinel
wh_occupation_decision_norsca_occupy_wh2_main_the_black_coast_arnheim	wh2_main_the_black_coast_arnheim
wh_occupation_decision_norsca_occupy_wh2_main_the_black_flood_hag_graef	wh2_main_the_black_flood_hag_graef
wh_occupation_decision_norsca_occupy_wh2_main_the_broken_land_blacklight_tower	wh2_main_the_broken_land_blacklight_tower
wh_occupation_decision_norsca_occupy_wh2_main_the_broken_land_karond_kar	wh2_main_the_broken_land_karond_kar
wh_occupation_decision_norsca_occupy_wh2_main_the_broken_land_slavers_point	wh2_main_the_broken_land_slavers_point
wh_occupation_decision_norsca_occupy_wh2_main_the_clawed_coast_the_twisted_glade	wh2_main_the_clawed_coast_the_twisted_glade
wh_occupation_decision_norsca_occupy_wh2_main_the_creeping_jungle_temple_of_kara	wh2_main_the_creeping_jungle_temple_of_kara
wh_occupation_decision_norsca_occupy_wh2_main_the_galleons_graveyard	wh2_main_the_galleons_graveyard
wh_occupation_decision_norsca_occupy_wh2_main_tiranoc_tor_anroc	wh2_main_tiranoc_tor_anroc
wh_occupation_decision_norsca_occupy_wh2_main_titan_peaks_the_moon_shard	wh2_main_titan_peaks_the_moon_shard
wh_occupation_decision_norsca_occupy_wh2_main_vampire_coast_pox_marsh	wh2_main_vampire_coast_pox_marsh
wh_occupation_decision_norsca_occupy_wh2_main_vampire_coast_the_awakening	wh2_main_vampire_coast_the_awakening
wh_occupation_decision_norsca_occupy_wh2_main_vampire_coast_the_blood_swamps	wh2_main_vampire_coast_the_blood_swamps
wh_occupation_decision_norsca_occupy_wh2_main_volcanic_islands_fuming_serpent	wh2_main_volcanic_islands_fuming_serpent
wh_occupation_decision_norsca_occupy_wh2_main_volcanic_islands_the_star_tower	wh2_main_volcanic_islands_the_star_tower
wh_occupation_decision_norsca_occupy_wh2_main_vor_aghol_wastelands_fortress_of_the_damned_wh2_main_nor_aghol	wh2_main_vor_aghol_wastelands_fortress_of_the_damned
wh_occupation_decision_norsca_occupy_wh2_main_vor_aghol_wastelands_fortress_of_the_damned_wh2_main_nor_mung	wh2_main_vor_aghol_wastelands_fortress_of_the_damned
wh_occupation_decision_norsca_occupy_wh2_main_vor_aghol_wastelands_fortress_of_the_damned_wh2_main_nor_skeggi	wh2_main_vor_aghol_wastelands_fortress_of_the_damned
wh_occupation_decision_norsca_occupy_wh2_main_vor_aghol_wastelands_fortress_of_the_damned_wh_main_nor_skaeling	wh2_main_vor_aghol_wastelands_fortress_of_the_damned
wh_occupation_decision_norsca_occupy_wh2_main_vor_aghol_wastelands_palace_of_princes_wh2_main_nor_aghol	wh2_main_vor_aghol_wastelands_palace_of_princes
wh_occupation_decision_norsca_occupy_wh2_main_vor_aghol_wastelands_palace_of_princes_wh2_main_nor_mung	wh2_main_vor_aghol_wastelands_palace_of_princes
wh_occupation_decision_norsca_occupy_wh2_main_vor_aghol_wastelands_palace_of_princes_wh2_main_nor_skeggi	wh2_main_vor_aghol_wastelands_palace_of_princes
wh_occupation_decision_norsca_occupy_wh2_main_vor_aghol_wastelands_palace_of_princes_wh_main_nor_skaeling	wh2_main_vor_aghol_wastelands_palace_of_princes
wh_occupation_decision_norsca_occupy_wh2_main_vor_aghol_wastelands_the_palace_of_ruin_wh2_main_nor_aghol	wh2_main_vor_aghol_wastelands_the_palace_of_ruin
wh_occupation_decision_norsca_occupy_wh2_main_vor_aghol_wastelands_the_palace_of_ruin_wh2_main_nor_mung	wh2_main_vor_aghol_wastelands_the_palace_of_ruin
wh_occupation_decision_norsca_occupy_wh2_main_vor_aghol_wastelands_the_palace_of_ruin_wh2_main_nor_skeggi	wh2_main_vor_aghol_wastelands_the_palace_of_ruin
wh_occupation_decision_norsca_occupy_wh2_main_vor_aghol_wastelands_the_palace_of_ruin_wh_main_nor_skaeling	wh2_main_vor_aghol_wastelands_the_palace_of_ruin
wh_occupation_decision_norsca_occupy_wh2_main_vor_albion_albion_wh2_main_nor_aghol	wh2_main_vor_albion_albion
wh_occupation_decision_norsca_occupy_wh2_main_vor_albion_albion_wh2_main_nor_mung	wh2_main_vor_albion_albion
wh_occupation_decision_norsca_occupy_wh2_main_vor_albion_albion_wh2_main_nor_skeggi	wh2_main_vor_albion_albion
wh_occupation_decision_norsca_occupy_wh2_main_vor_albion_albion_wh_main_nor_skaeling	wh2_main_vor_albion_albion
wh_occupation_decision_norsca_occupy_wh2_main_vor_albion_pack_ice_bay_wh2_main_nor_aghol	wh2_main_vor_albion_pack_ice_bay
wh_occupation_decision_norsca_occupy_wh2_main_vor_albion_pack_ice_bay_wh2_main_nor_mung	wh2_main_vor_albion_pack_ice_bay
wh_occupation_decision_norsca_occupy_wh2_main_vor_albion_pack_ice_bay_wh2_main_nor_skeggi	wh2_main_vor_albion_pack_ice_bay
wh_occupation_decision_norsca_occupy_wh2_main_vor_albion_pack_ice_bay_wh_main_nor_skaeling	wh2_main_vor_albion_pack_ice_bay
wh_occupation_decision_norsca_occupy_wh2_main_vor_albion_troll_fjord_wh2_main_nor_aghol	wh2_main_vor_albion_troll_fjord
wh_occupation_decision_norsca_occupy_wh2_main_vor_albion_troll_fjord_wh2_main_nor_mung	wh2_main_vor_albion_troll_fjord
wh_occupation_decision_norsca_occupy_wh2_main_vor_albion_troll_fjord_wh2_main_nor_skeggi	wh2_main_vor_albion_troll_fjord
wh_occupation_decision_norsca_occupy_wh2_main_vor_albion_troll_fjord_wh_main_nor_skaeling	wh2_main_vor_albion_troll_fjord
wh_occupation_decision_norsca_occupy_wh2_main_vor_avalorn_gaean_vale_wh2_main_nor_aghol	wh2_main_vor_avelorn_gaean_vale
wh_occupation_decision_norsca_occupy_wh2_main_vor_avalorn_gaean_vale_wh2_main_nor_mung	wh2_main_vor_avelorn_gaean_vale
wh_occupation_decision_norsca_occupy_wh2_main_vor_avalorn_gaean_vale_wh2_main_nor_skeggi	wh2_main_vor_avelorn_gaean_vale
wh_occupation_decision_norsca_occupy_wh2_main_vor_avalorn_gaean_vale_wh_main_nor_skaeling	wh2_main_vor_avelorn_gaean_vale
wh_occupation_decision_norsca_occupy_wh2_main_vor_avelorn_evershale_wh2_main_nor_aghol	wh2_main_vor_avelorn_evershale
wh_occupation_decision_norsca_occupy_wh2_main_vor_avelorn_evershale_wh2_main_nor_mung	wh2_main_vor_avelorn_evershale
wh_occupation_decision_norsca_occupy_wh2_main_vor_avelorn_evershale_wh2_main_nor_skeggi	wh2_main_vor_avelorn_evershale
wh_occupation_decision_norsca_occupy_wh2_main_vor_avelorn_evershale_wh_main_nor_skaeling	wh2_main_vor_avelorn_evershale
wh_occupation_decision_norsca_occupy_wh2_main_vor_chrace_elisia_wh2_main_nor_aghol	wh2_main_vor_chrace_elisia
wh_occupation_decision_norsca_occupy_wh2_main_vor_chrace_elisia_wh2_main_nor_mung	wh2_main_vor_chrace_elisia
wh_occupation_decision_norsca_occupy_wh2_main_vor_chrace_elisia_wh2_main_nor_skeggi	wh2_main_vor_chrace_elisia
wh_occupation_decision_norsca_occupy_wh2_main_vor_chrace_elisia_wh_main_nor_skaeling	wh2_main_vor_chrace_elisia
wh_occupation_decision_norsca_occupy_wh2_main_vor_coast_of_araby_al_haikk_wh2_main_nor_aghol	wh2_main_vor_coast_of_araby_al_haikk
wh_occupation_decision_norsca_occupy_wh2_main_vor_coast_of_araby_al_haikk_wh2_main_nor_mung	wh2_main_vor_coast_of_araby_al_haikk
wh_occupation_decision_norsca_occupy_wh2_main_vor_coast_of_araby_al_haikk_wh2_main_nor_skeggi	wh2_main_vor_coast_of_araby_al_haikk
wh_occupation_decision_norsca_occupy_wh2_main_vor_coast_of_araby_al_haikk_wh_main_nor_skaeling	wh2_main_vor_coast_of_araby_al_haikk
wh_occupation_decision_norsca_occupy_wh2_main_vor_coast_of_araby_copher_wh2_main_nor_aghol	wh2_main_vor_coast_of_araby_copher
wh_occupation_decision_norsca_occupy_wh2_main_vor_coast_of_araby_copher_wh2_main_nor_mung	wh2_main_vor_coast_of_araby_copher
wh_occupation_decision_norsca_occupy_wh2_main_vor_coast_of_araby_copher_wh2_main_nor_skeggi	wh2_main_vor_coast_of_araby_copher
wh_occupation_decision_norsca_occupy_wh2_main_vor_coast_of_araby_copher_wh_main_nor_skaeling	wh2_main_vor_coast_of_araby_copher
wh_occupation_decision_norsca_occupy_wh2_main_vor_coast_of_squalls_monument_of_the_sun_wh2_main_nor_aghol	wh2_main_vor_coast_of_squalls_monument_of_the_sun
wh_occupation_decision_norsca_occupy_wh2_main_vor_coast_of_squalls_monument_of_the_sun_wh2_main_nor_mung	wh2_main_vor_coast_of_squalls_monument_of_the_sun
wh_occupation_decision_norsca_occupy_wh2_main_vor_coast_of_squalls_monument_of_the_sun_wh2_main_nor_skeggi	wh2_main_vor_coast_of_squalls_monument_of_the_sun
wh_occupation_decision_norsca_occupy_wh2_main_vor_coast_of_squalls_monument_of_the_sun_wh_main_nor_skaeling	wh2_main_vor_coast_of_squalls_monument_of_the_sun
wh_occupation_decision_norsca_occupy_wh2_main_vor_copper_desert_the_forgotten_isles_wh2_main_nor_aghol	wh2_main_vor_copper_desert_the_forgotten_isles
wh_occupation_decision_norsca_occupy_wh2_main_vor_copper_desert_the_forgotten_isles_wh2_main_nor_mung	wh2_main_vor_copper_desert_the_forgotten_isles
wh_occupation_decision_norsca_occupy_wh2_main_vor_copper_desert_the_forgotten_isles_wh2_main_nor_skeggi	wh2_main_vor_copper_desert_the_forgotten_isles
wh_occupation_decision_norsca_occupy_wh2_main_vor_copper_desert_the_forgotten_isles_wh_main_nor_skaeling	wh2_main_vor_copper_desert_the_forgotten_isles
wh_occupation_decision_norsca_occupy_wh2_main_vor_cothique_mistnar_wh2_main_nor_aghol	wh2_main_vor_cothique_mistnar
wh_occupation_decision_norsca_occupy_wh2_main_vor_cothique_mistnar_wh2_main_nor_mung	wh2_main_vor_cothique_mistnar
wh_occupation_decision_norsca_occupy_wh2_main_vor_cothique_mistnar_wh2_main_nor_skeggi	wh2_main_vor_cothique_mistnar
wh_occupation_decision_norsca_occupy_wh2_main_vor_cothique_mistnar_wh_main_nor_skaeling	wh2_main_vor_cothique_mistnar
wh_occupation_decision_norsca_occupy_wh2_main_vor_cothique_tor_koruali_wh2_main_nor_aghol	wh2_main_vor_cothique_tor_koruali
wh_occupation_decision_norsca_occupy_wh2_main_vor_cothique_tor_koruali_wh2_main_nor_mung	wh2_main_vor_cothique_tor_koruali
wh_occupation_decision_norsca_occupy_wh2_main_vor_cothique_tor_koruali_wh2_main_nor_skeggi	wh2_main_vor_cothique_tor_koruali
wh_occupation_decision_norsca_occupy_wh2_main_vor_cothique_tor_koruali_wh_main_nor_skaeling	wh2_main_vor_cothique_tor_koruali
wh_occupation_decision_norsca_occupy_wh2_main_vor_culchan_plains_chupayotl_wh2_main_nor_aghol	wh2_main_vor_culchan_plains_chupayotl
wh_occupation_decision_norsca_occupy_wh2_main_vor_culchan_plains_chupayotl_wh2_main_nor_mung	wh2_main_vor_culchan_plains_chupayotl
wh_occupation_decision_norsca_occupy_wh2_main_vor_culchan_plains_chupayotl_wh2_main_nor_skeggi	wh2_main_vor_culchan_plains_chupayotl
wh_occupation_decision_norsca_occupy_wh2_main_vor_culchan_plains_chupayotl_wh_main_nor_skaeling	wh2_main_vor_culchan_plains_chupayotl
wh_occupation_decision_norsca_occupy_wh2_main_vor_culchan_plains_kaiax_wh2_main_nor_aghol	wh2_main_vor_culchan_plains_kaiax
wh_occupation_decision_norsca_occupy_wh2_main_vor_culchan_plains_kaiax_wh2_main_nor_mung	wh2_main_vor_culchan_plains_kaiax
wh_occupation_decision_norsca_occupy_wh2_main_vor_culchan_plains_kaiax_wh2_main_nor_skeggi	wh2_main_vor_culchan_plains_kaiax
wh_occupation_decision_norsca_occupy_wh2_main_vor_culchan_plains_kaiax_wh_main_nor_skaeling	wh2_main_vor_culchan_plains_kaiax
wh_occupation_decision_norsca_occupy_wh2_main_vor_deadwood_nagrar_wh2_main_nor_aghol	wh2_main_vor_deadwood_nagrar
wh_occupation_decision_norsca_occupy_wh2_main_vor_deadwood_nagrar_wh2_main_nor_mung	wh2_main_vor_deadwood_nagrar
wh_occupation_decision_norsca_occupy_wh2_main_vor_deadwood_nagrar_wh2_main_nor_skeggi	wh2_main_vor_deadwood_nagrar
wh_occupation_decision_norsca_occupy_wh2_main_vor_deadwood_nagrar_wh_main_nor_skaeling	wh2_main_vor_deadwood_nagrar
wh_occupation_decision_norsca_occupy_wh2_main_vor_deadwood_shagrath_wh2_main_nor_aghol	wh2_main_vor_deadwood_shagrath
wh_occupation_decision_norsca_occupy_wh2_main_vor_deadwood_shagrath_wh2_main_nor_mung	wh2_main_vor_deadwood_shagrath
wh_occupation_decision_norsca_occupy_wh2_main_vor_deadwood_shagrath_wh2_main_nor_skeggi	wh2_main_vor_deadwood_shagrath
wh_occupation_decision_norsca_occupy_wh2_main_vor_deadwood_shagrath_wh_main_nor_skaeling	wh2_main_vor_deadwood_shagrath
wh_occupation_decision_norsca_occupy_wh2_main_vor_eataine_angerrial_wh2_main_nor_aghol	wh2_main_vor_eataine_angerrial
wh_occupation_decision_norsca_occupy_wh2_main_vor_eataine_angerrial_wh2_main_nor_mung	wh2_main_vor_eataine_angerrial
wh_occupation_decision_norsca_occupy_wh2_main_vor_eataine_angerrial_wh2_main_nor_skeggi	wh2_main_vor_eataine_angerrial
wh_occupation_decision_norsca_occupy_wh2_main_vor_eataine_angerrial_wh_main_nor_skaeling	wh2_main_vor_eataine_angerrial
wh_occupation_decision_norsca_occupy_wh2_main_vor_ellyrion_tor_elyr_wh2_main_nor_aghol	wh2_main_vor_ellyrion_tor_elyr
wh_occupation_decision_norsca_occupy_wh2_main_vor_ellyrion_tor_elyr_wh2_main_nor_mung	wh2_main_vor_ellyrion_tor_elyr
wh_occupation_decision_norsca_occupy_wh2_main_vor_ellyrion_tor_elyr_wh2_main_nor_skeggi	wh2_main_vor_ellyrion_tor_elyr
wh_occupation_decision_norsca_occupy_wh2_main_vor_ellyrion_tor_elyr_wh_main_nor_skaeling	wh2_main_vor_ellyrion_tor_elyr
wh_occupation_decision_norsca_occupy_wh2_main_vor_grey_guardians_grey_rock_point_wh2_main_nor_aghol	wh2_main_vor_grey_guardians_grey_rock_point
wh_occupation_decision_norsca_occupy_wh2_main_vor_grey_guardians_grey_rock_point_wh2_main_nor_mung	wh2_main_vor_grey_guardians_grey_rock_point
wh_occupation_decision_norsca_occupy_wh2_main_vor_grey_guardians_grey_rock_point_wh2_main_nor_skeggi	wh2_main_vor_grey_guardians_grey_rock_point
wh_occupation_decision_norsca_occupy_wh2_main_vor_grey_guardians_grey_rock_point_wh_main_nor_skaeling	wh2_main_vor_grey_guardians_grey_rock_point
wh_occupation_decision_norsca_occupy_wh2_main_vor_grey_guardians_sulpharets_wh2_main_nor_aghol	wh2_main_vor_grey_guardians_sulpharets
wh_occupation_decision_norsca_occupy_wh2_main_vor_grey_guardians_sulpharets_wh2_main_nor_mung	wh2_main_vor_grey_guardians_sulpharets
wh_occupation_decision_norsca_occupy_wh2_main_vor_grey_guardians_sulpharets_wh2_main_nor_skeggi	wh2_main_vor_grey_guardians_sulpharets
wh_occupation_decision_norsca_occupy_wh2_main_vor_grey_guardians_sulpharets_wh_main_nor_skaeling	wh2_main_vor_grey_guardians_sulpharets
wh_occupation_decision_norsca_occupy_wh2_main_vor_headhunters_jungle_altar_of_the_horned_rat_wh2_main_nor_aghol	wh2_main_vor_headhunters_jungle_altar_of_the_horned_rat
wh_occupation_decision_norsca_occupy_wh2_main_vor_headhunters_jungle_altar_of_the_horned_rat_wh2_main_nor_mung	wh2_main_vor_headhunters_jungle_altar_of_the_horned_rat
wh_occupation_decision_norsca_occupy_wh2_main_vor_headhunters_jungle_altar_of_the_horned_rat_wh2_main_nor_skeggi	wh2_main_vor_headhunters_jungle_altar_of_the_horned_rat
wh_occupation_decision_norsca_occupy_wh2_main_vor_headhunters_jungle_altar_of_the_horned_rat_wh_main_nor_skaeling	wh2_main_vor_headhunters_jungle_altar_of_the_horned_rat
wh_occupation_decision_norsca_occupy_wh2_main_vor_ironfrost_glacier_bear_isle_wh2_main_nor_aghol	wh2_main_vor_ironfrost_glacier_bear_isle
wh_occupation_decision_norsca_occupy_wh2_main_vor_ironfrost_glacier_bear_isle_wh2_main_nor_mung	wh2_main_vor_ironfrost_glacier_bear_isle
wh_occupation_decision_norsca_occupy_wh2_main_vor_ironfrost_glacier_bear_isle_wh2_main_nor_skeggi	wh2_main_vor_ironfrost_glacier_bear_isle
wh_occupation_decision_norsca_occupy_wh2_main_vor_ironfrost_glacier_bear_isle_wh_main_nor_skaeling	wh2_main_vor_ironfrost_glacier_bear_isle
wh_occupation_decision_norsca_occupy_wh2_main_vor_ironfrost_glacier_dagraks_end_wh2_main_nor_aghol	wh2_main_vor_ironfrost_glacier_dagraks_end
wh_occupation_decision_norsca_occupy_wh2_main_vor_ironfrost_glacier_dagraks_end_wh2_main_nor_mung	wh2_main_vor_ironfrost_glacier_dagraks_end
wh_occupation_decision_norsca_occupy_wh2_main_vor_ironfrost_glacier_dagraks_end_wh2_main_nor_skeggi	wh2_main_vor_ironfrost_glacier_dagraks_end
wh_occupation_decision_norsca_occupy_wh2_main_vor_ironfrost_glacier_dagraks_end_wh_main_nor_skaeling	wh2_main_vor_ironfrost_glacier_dagraks_end
wh_occupation_decision_norsca_occupy_wh2_main_vor_ironfrost_glacier_ironfrost_wh2_main_nor_aghol	wh2_main_vor_ironfrost_glacier_ironfrost
wh_occupation_decision_norsca_occupy_wh2_main_vor_ironfrost_glacier_ironfrost_wh2_main_nor_mung	wh2_main_vor_ironfrost_glacier_ironfrost
wh_occupation_decision_norsca_occupy_wh2_main_vor_ironfrost_glacier_ironfrost_wh2_main_nor_skeggi	wh2_main_vor_ironfrost_glacier_ironfrost
wh_occupation_decision_norsca_occupy_wh2_main_vor_ironfrost_glacier_ironfrost_wh_main_nor_skaeling	wh2_main_vor_ironfrost_glacier_ironfrost
wh_occupation_decision_norsca_occupy_wh2_main_vor_ironfrost_glacier_mung_encampment_wh2_main_nor_aghol	wh2_main_vor_ironfrost_glacier_mung_encampment
wh_occupation_decision_norsca_occupy_wh2_main_vor_ironfrost_glacier_mung_encampment_wh2_main_nor_mung	wh2_main_vor_ironfrost_glacier_mung_encampment
wh_occupation_decision_norsca_occupy_wh2_main_vor_ironfrost_glacier_mung_encampment_wh2_main_nor_skeggi	wh2_main_vor_ironfrost_glacier_mung_encampment
wh_occupation_decision_norsca_occupy_wh2_main_vor_ironfrost_glacier_mung_encampment_wh_main_nor_skaeling	wh2_main_vor_ironfrost_glacier_mung_encampment
wh_occupation_decision_norsca_occupy_wh2_main_vor_isthmus_of_lustria_hexoatl_wh2_main_nor_aghol	wh2_main_vor_isthmus_of_lustria_hexoatl
wh_occupation_decision_norsca_occupy_wh2_main_vor_isthmus_of_lustria_hexoatl_wh2_main_nor_mung	wh2_main_vor_isthmus_of_lustria_hexoatl
wh_occupation_decision_norsca_occupy_wh2_main_vor_isthmus_of_lustria_hexoatl_wh2_main_nor_skeggi	wh2_main_vor_isthmus_of_lustria_hexoatl
wh_occupation_decision_norsca_occupy_wh2_main_vor_isthmus_of_lustria_hexoatl_wh_main_nor_skaeling	wh2_main_vor_isthmus_of_lustria_hexoatl
wh_occupation_decision_norsca_occupy_wh2_main_vor_isthmus_of_lustria_monolith_of_fallen_gods_wh2_main_nor_aghol	wh2_main_vor_isthmus_of_lustria_monolith_of_fallen_gods
wh_occupation_decision_norsca_occupy_wh2_main_vor_isthmus_of_lustria_monolith_of_fallen_gods_wh2_main_nor_mung	wh2_main_vor_isthmus_of_lustria_monolith_of_fallen_gods
wh_occupation_decision_norsca_occupy_wh2_main_vor_isthmus_of_lustria_monolith_of_fallen_gods_wh2_main_nor_skeggi	wh2_main_vor_isthmus_of_lustria_monolith_of_fallen_gods
wh_occupation_decision_norsca_occupy_wh2_main_vor_isthmus_of_lustria_monolith_of_fallen_gods_wh_main_nor_skaeling	wh2_main_vor_isthmus_of_lustria_monolith_of_fallen_gods
wh_occupation_decision_norsca_occupy_wh2_main_vor_isthmus_of_lustria_ziggurat_of_dawn_wh2_main_nor_aghol	wh2_main_vor_isthmus_of_lustria_ziggurat_of_dawn
wh_occupation_decision_norsca_occupy_wh2_main_vor_isthmus_of_lustria_ziggurat_of_dawn_wh2_main_nor_mung	wh2_main_vor_isthmus_of_lustria_ziggurat_of_dawn
wh_occupation_decision_norsca_occupy_wh2_main_vor_isthmus_of_lustria_ziggurat_of_dawn_wh2_main_nor_skeggi	wh2_main_vor_isthmus_of_lustria_ziggurat_of_dawn
wh_occupation_decision_norsca_occupy_wh2_main_vor_isthmus_of_lustria_ziggurat_of_dawn_wh_main_nor_skaeling	wh2_main_vor_isthmus_of_lustria_ziggurat_of_dawn
wh_occupation_decision_norsca_occupy_wh2_main_vor_jungle_of_pahualaxa_monument_of_the_moon_wh2_main_nor_aghol	wh2_main_vor_jungle_of_pahualaxa_monument_of_the_moon
wh_occupation_decision_norsca_occupy_wh2_main_vor_jungle_of_pahualaxa_monument_of_the_moon_wh2_main_nor_mung	wh2_main_vor_jungle_of_pahualaxa_monument_of_the_moon
wh_occupation_decision_norsca_occupy_wh2_main_vor_jungle_of_pahualaxa_monument_of_the_moon_wh2_main_nor_skeggi	wh2_main_vor_jungle_of_pahualaxa_monument_of_the_moon
wh_occupation_decision_norsca_occupy_wh2_main_vor_jungle_of_pahualaxa_monument_of_the_moon_wh_main_nor_skaeling	wh2_main_vor_jungle_of_pahualaxa_monument_of_the_moon
wh_occupation_decision_norsca_occupy_wh2_main_vor_kingdom_of_beasts_serpent_coast_wh2_main_nor_aghol	wh2_main_vor_kingdom_of_beasts_serpent_coast
wh_occupation_decision_norsca_occupy_wh2_main_vor_kingdom_of_beasts_serpent_coast_wh2_main_nor_mung	wh2_main_vor_kingdom_of_beasts_serpent_coast
wh_occupation_decision_norsca_occupy_wh2_main_vor_kingdom_of_beasts_serpent_coast_wh2_main_nor_skeggi	wh2_main_vor_kingdom_of_beasts_serpent_coast
wh_occupation_decision_norsca_occupy_wh2_main_vor_kingdom_of_beasts_serpent_coast_wh_main_nor_skaeling	wh2_main_vor_kingdom_of_beasts_serpent_coast
wh_occupation_decision_norsca_occupy_wh2_main_vor_land_of_assassins_lashiek_wh2_main_nor_aghol	wh2_main_vor_land_of_assassins_lashiek
wh_occupation_decision_norsca_occupy_wh2_main_vor_land_of_assassins_lashiek_wh2_main_nor_mung	wh2_main_vor_land_of_assassins_lashiek
wh_occupation_decision_norsca_occupy_wh2_main_vor_land_of_assassins_lashiek_wh2_main_nor_skeggi	wh2_main_vor_land_of_assassins_lashiek
wh_occupation_decision_norsca_occupy_wh2_main_vor_land_of_assassins_lashiek_wh_main_nor_skaeling	wh2_main_vor_land_of_assassins_lashiek
wh_occupation_decision_norsca_occupy_wh2_main_vor_land_of_assassins_sorcerers_islands_wh2_main_nor_aghol	wh2_main_vor_land_of_assassins_sorcerers_islands
wh_occupation_decision_norsca_occupy_wh2_main_vor_land_of_assassins_sorcerers_islands_wh2_main_nor_mung	wh2_main_vor_land_of_assassins_sorcerers_islands
wh_occupation_decision_norsca_occupy_wh2_main_vor_land_of_assassins_sorcerers_islands_wh2_main_nor_skeggi	wh2_main_vor_land_of_assassins_sorcerers_islands
wh_occupation_decision_norsca_occupy_wh2_main_vor_land_of_assassins_sorcerers_islands_wh_main_nor_skaeling	wh2_main_vor_land_of_assassins_sorcerers_islands
wh_occupation_decision_norsca_occupy_wh2_main_vor_land_of_the_dead_khemri_wh2_main_nor_aghol	wh2_main_vor_land_of_the_dead_khemri
wh_occupation_decision_norsca_occupy_wh2_main_vor_land_of_the_dead_khemri_wh2_main_nor_mung	wh2_main_vor_land_of_the_dead_khemri
wh_occupation_decision_norsca_occupy_wh2_main_vor_land_of_the_dead_khemri_wh2_main_nor_skeggi	wh2_main_vor_land_of_the_dead_khemri
wh_occupation_decision_norsca_occupy_wh2_main_vor_land_of_the_dead_khemri_wh_main_nor_skaeling	wh2_main_vor_land_of_the_dead_khemri
wh_occupation_decision_norsca_occupy_wh2_main_vor_land_of_the_dead_zandri_wh2_main_nor_aghol	wh2_main_vor_land_of_the_dead_zandri
wh_occupation_decision_norsca_occupy_wh2_main_vor_land_of_the_dead_zandri_wh2_main_nor_mung	wh2_main_vor_land_of_the_dead_zandri
wh_occupation_decision_norsca_occupy_wh2_main_vor_land_of_the_dead_zandri_wh2_main_nor_skeggi	wh2_main_vor_land_of_the_dead_zandri
wh_occupation_decision_norsca_occupy_wh2_main_vor_land_of_the_dead_zandri_wh_main_nor_skaeling	wh2_main_vor_land_of_the_dead_zandri
wh_occupation_decision_norsca_occupy_wh2_main_vor_land_of_the_dervishes_elven_ruins_wh2_main_nor_aghol	wh2_main_vor_land_of_the_dervishes_elven_ruins
wh_occupation_decision_norsca_occupy_wh2_main_vor_land_of_the_dervishes_elven_ruins_wh2_main_nor_mung	wh2_main_vor_land_of_the_dervishes_elven_ruins
wh_occupation_decision_norsca_occupy_wh2_main_vor_land_of_the_dervishes_elven_ruins_wh2_main_nor_skeggi	wh2_main_vor_land_of_the_dervishes_elven_ruins
wh_occupation_decision_norsca_occupy_wh2_main_vor_land_of_the_dervishes_elven_ruins_wh_main_nor_skaeling	wh2_main_vor_land_of_the_dervishes_elven_ruins
wh_occupation_decision_norsca_occupy_wh2_main_vor_land_of_the_dervishes_sudenburg_wh2_main_nor_aghol	wh2_main_vor_land_of_the_dervishes_sudenburg
wh_occupation_decision_norsca_occupy_wh2_main_vor_land_of_the_dervishes_sudenburg_wh2_main_nor_mung	wh2_main_vor_land_of_the_dervishes_sudenburg
wh_occupation_decision_norsca_occupy_wh2_main_vor_land_of_the_dervishes_sudenburg_wh2_main_nor_skeggi	wh2_main_vor_land_of_the_dervishes_sudenburg
wh_occupation_decision_norsca_occupy_wh2_main_vor_land_of_the_dervishes_sudenburg_wh_main_nor_skaeling	wh2_main_vor_land_of_the_dervishes_sudenburg
wh_occupation_decision_norsca_occupy_wh2_main_vor_nagarythe_tor_anlec_wh2_main_nor_aghol	wh2_main_vor_nagarythe_tor_anlec
wh_occupation_decision_norsca_occupy_wh2_main_vor_nagarythe_tor_anlec_wh2_main_nor_mung	wh2_main_vor_nagarythe_tor_anlec
wh_occupation_decision_norsca_occupy_wh2_main_vor_nagarythe_tor_anlec_wh2_main_nor_skeggi	wh2_main_vor_nagarythe_tor_anlec
wh_occupation_decision_norsca_occupy_wh2_main_vor_nagarythe_tor_anlec_wh_main_nor_skaeling	wh2_main_vor_nagarythe_tor_anlec
wh_occupation_decision_norsca_occupy_wh2_main_vor_naggarond_naggarond_wh2_main_nor_aghol	wh2_main_vor_naggarond_naggarond
wh_occupation_decision_norsca_occupy_wh2_main_vor_naggarond_naggarond_wh2_main_nor_mung	wh2_main_vor_naggarond_naggarond
wh_occupation_decision_norsca_occupy_wh2_main_vor_naggarond_naggarond_wh2_main_nor_skeggi	wh2_main_vor_naggarond_naggarond
wh_occupation_decision_norsca_occupy_wh2_main_vor_naggarond_naggarond_wh_main_nor_skaeling	wh2_main_vor_naggarond_naggarond
wh_occupation_decision_norsca_occupy_wh2_main_vor_northern_great_jungle_itza_wh2_main_nor_aghol	wh2_main_vor_northern_great_jungle_itza
wh_occupation_decision_norsca_occupy_wh2_main_vor_northern_great_jungle_itza_wh2_main_nor_mung	wh2_main_vor_northern_great_jungle_itza
wh_occupation_decision_norsca_occupy_wh2_main_vor_northern_great_jungle_itza_wh2_main_nor_skeggi	wh2_main_vor_northern_great_jungle_itza
wh_occupation_decision_norsca_occupy_wh2_main_vor_northern_great_jungle_itza_wh_main_nor_skaeling	wh2_main_vor_northern_great_jungle_itza
wh_occupation_decision_norsca_occupy_wh2_main_vor_northern_yvresse_sardenath_wh2_main_nor_aghol	wh2_main_vor_northern_yvresse_sardenath
wh_occupation_decision_norsca_occupy_wh2_main_vor_northern_yvresse_sardenath_wh2_main_nor_mung	wh2_main_vor_northern_yvresse_sardenath
wh_occupation_decision_norsca_occupy_wh2_main_vor_northern_yvresse_sardenath_wh2_main_nor_skeggi	wh2_main_vor_northern_yvresse_sardenath
wh_occupation_decision_norsca_occupy_wh2_main_vor_northern_yvresse_sardenath_wh_main_nor_skaeling	wh2_main_vor_northern_yvresse_sardenath
wh_occupation_decision_norsca_occupy_wh2_main_vor_northern_yvresse_tralinia_wh2_main_nor_aghol	wh2_main_vor_northern_yvresse_tralinia
wh_occupation_decision_norsca_occupy_wh2_main_vor_northern_yvresse_tralinia_wh2_main_nor_mung	wh2_main_vor_northern_yvresse_tralinia
wh_occupation_decision_norsca_occupy_wh2_main_vor_northern_yvresse_tralinia_wh2_main_nor_skeggi	wh2_main_vor_northern_yvresse_tralinia
wh_occupation_decision_norsca_occupy_wh2_main_vor_northern_yvresse_tralinia_wh_main_nor_skaeling	wh2_main_vor_northern_yvresse_tralinia
wh_occupation_decision_norsca_occupy_wh2_main_vor_plain_of_spiders_clarak_spire_wh2_main_nor_aghol	wh2_main_vor_plain_of_spiders_clarak_spire
wh_occupation_decision_norsca_occupy_wh2_main_vor_plain_of_spiders_clarak_spire_wh2_main_nor_mung	wh2_main_vor_plain_of_spiders_clarak_spire
wh_occupation_decision_norsca_occupy_wh2_main_vor_plain_of_spiders_clarak_spire_wh2_main_nor_skeggi	wh2_main_vor_plain_of_spiders_clarak_spire
wh_occupation_decision_norsca_occupy_wh2_main_vor_plain_of_spiders_clarak_spire_wh_main_nor_skaeling	wh2_main_vor_plain_of_spiders_clarak_spire
wh_occupation_decision_norsca_occupy_wh2_main_vor_red_desert_drackla_spire_wh2_main_nor_aghol	wh2_main_vor_red_desert_drackla_spire
wh_occupation_decision_norsca_occupy_wh2_main_vor_red_desert_drackla_spire_wh2_main_nor_mung	wh2_main_vor_red_desert_drackla_spire
wh_occupation_decision_norsca_occupy_wh2_main_vor_red_desert_drackla_spire_wh2_main_nor_skeggi	wh2_main_vor_red_desert_drackla_spire
wh_occupation_decision_norsca_occupy_wh2_main_vor_red_desert_drackla_spire_wh_main_nor_skaeling	wh2_main_vor_red_desert_drackla_spire
wh_occupation_decision_norsca_occupy_wh2_main_vor_river_qurveza_mouth_of_qurveza_wh2_main_nor_aghol	wh2_main_vor_river_qurveza_mouth_of_qurveza
wh_occupation_decision_norsca_occupy_wh2_main_vor_river_qurveza_mouth_of_qurveza_wh2_main_nor_mung	wh2_main_vor_river_qurveza_mouth_of_qurveza
wh_occupation_decision_norsca_occupy_wh2_main_vor_river_qurveza_mouth_of_qurveza_wh2_main_nor_skeggi	wh2_main_vor_river_qurveza_mouth_of_qurveza
wh_occupation_decision_norsca_occupy_wh2_main_vor_river_qurveza_mouth_of_qurveza_wh_main_nor_skaeling	wh2_main_vor_river_qurveza_mouth_of_qurveza
wh_occupation_decision_norsca_occupy_wh2_main_vor_saphery_port_elistor_wh2_main_nor_aghol	wh2_main_vor_saphery_port_elistor
wh_occupation_decision_norsca_occupy_wh2_main_vor_saphery_port_elistor_wh2_main_nor_mung	wh2_main_vor_saphery_port_elistor
wh_occupation_decision_norsca_occupy_wh2_main_vor_saphery_port_elistor_wh2_main_nor_skeggi	wh2_main_vor_saphery_port_elistor
wh_occupation_decision_norsca_occupy_wh2_main_vor_saphery_port_elistor_wh_main_nor_skaeling	wh2_main_vor_saphery_port_elistor
wh_occupation_decision_norsca_occupy_wh2_main_vor_sartosa_sartosa_wh2_main_nor_aghol	wh2_main_vor_sartosa_sartosa
wh_occupation_decision_norsca_occupy_wh2_main_vor_sartosa_sartosa_wh2_main_nor_mung	wh2_main_vor_sartosa_sartosa
wh_occupation_decision_norsca_occupy_wh2_main_vor_sartosa_sartosa_wh2_main_nor_skeggi	wh2_main_vor_sartosa_sartosa
wh_occupation_decision_norsca_occupy_wh2_main_vor_sartosa_sartosa_wh_main_nor_skaeling	wh2_main_vor_sartosa_sartosa
wh_occupation_decision_norsca_occupy_wh2_main_vor_scorpion_coast_chotec_wh2_main_nor_aghol	wh2_main_vor_scorpion_coast_chotec
wh_occupation_decision_norsca_occupy_wh2_main_vor_scorpion_coast_chotec_wh2_main_nor_mung	wh2_main_vor_scorpion_coast_chotec
wh_occupation_decision_norsca_occupy_wh2_main_vor_scorpion_coast_chotec_wh2_main_nor_skeggi	wh2_main_vor_scorpion_coast_chotec
wh_occupation_decision_norsca_occupy_wh2_main_vor_scorpion_coast_chotec_wh_main_nor_skaeling	wh2_main_vor_scorpion_coast_chotec
wh_occupation_decision_norsca_occupy_wh2_main_vor_scorpion_coast_temple_of_tlencan_wh2_main_nor_aghol	wh2_main_vor_scorpion_coast_temple_of_tlencan
wh_occupation_decision_norsca_occupy_wh2_main_vor_scorpion_coast_temple_of_tlencan_wh2_main_nor_mung	wh2_main_vor_scorpion_coast_temple_of_tlencan
wh_occupation_decision_norsca_occupy_wh2_main_vor_scorpion_coast_temple_of_tlencan_wh2_main_nor_skeggi	wh2_main_vor_scorpion_coast_temple_of_tlencan
wh_occupation_decision_norsca_occupy_wh2_main_vor_scorpion_coast_temple_of_tlencan_wh_main_nor_skaeling	wh2_main_vor_scorpion_coast_temple_of_tlencan
wh_occupation_decision_norsca_occupy_wh2_main_vor_sea_of_dread_tor_elasor_wh2_main_nor_aghol	wh2_main_vor_sea_of_dread_tor_elasor
wh_occupation_decision_norsca_occupy_wh2_main_vor_sea_of_dread_tor_elasor_wh2_main_nor_mung	wh2_main_vor_sea_of_dread_tor_elasor
wh_occupation_decision_norsca_occupy_wh2_main_vor_sea_of_dread_tor_elasor_wh2_main_nor_skeggi	wh2_main_vor_sea_of_dread_tor_elasor
wh_occupation_decision_norsca_occupy_wh2_main_vor_sea_of_dread_tor_elasor_wh_main_nor_skaeling	wh2_main_vor_sea_of_dread_tor_elasor
wh_occupation_decision_norsca_occupy_wh2_main_vor_sea_of_dread_tower_of_the_stars_wh2_main_nor_aghol	wh2_main_vor_sea_of_dread_tower_of_the_stars
wh_occupation_decision_norsca_occupy_wh2_main_vor_sea_of_dread_tower_of_the_stars_wh2_main_nor_mung	wh2_main_vor_sea_of_dread_tower_of_the_stars
wh_occupation_decision_norsca_occupy_wh2_main_vor_sea_of_dread_tower_of_the_stars_wh2_main_nor_skeggi	wh2_main_vor_sea_of_dread_tower_of_the_stars
wh_occupation_decision_norsca_occupy_wh2_main_vor_sea_of_dread_tower_of_the_stars_wh_main_nor_skaeling	wh2_main_vor_sea_of_dread_tower_of_the_stars
wh_occupation_decision_norsca_occupy_wh2_main_vor_sea_of_dread_tower_of_the_sun_wh2_main_nor_aghol	wh2_main_vor_sea_of_dread_tower_of_the_sun
wh_occupation_decision_norsca_occupy_wh2_main_vor_sea_of_dread_tower_of_the_sun_wh2_main_nor_mung	wh2_main_vor_sea_of_dread_tower_of_the_sun
wh_occupation_decision_norsca_occupy_wh2_main_vor_sea_of_dread_tower_of_the_sun_wh2_main_nor_skeggi	wh2_main_vor_sea_of_dread_tower_of_the_sun
wh_occupation_decision_norsca_occupy_wh2_main_vor_sea_of_dread_tower_of_the_sun_wh_main_nor_skaeling	wh2_main_vor_sea_of_dread_tower_of_the_sun
wh_occupation_decision_norsca_occupy_wh2_main_vor_settlers_coast_port_reaver_wh2_main_nor_aghol	wh2_main_vor_settlers_coast_port_reaver
wh_occupation_decision_norsca_occupy_wh2_main_vor_settlers_coast_port_reaver_wh2_main_nor_mung	wh2_main_vor_settlers_coast_port_reaver
wh_occupation_decision_norsca_occupy_wh2_main_vor_settlers_coast_port_reaver_wh2_main_nor_skeggi	wh2_main_vor_settlers_coast_port_reaver
wh_occupation_decision_norsca_occupy_wh2_main_vor_settlers_coast_port_reaver_wh_main_nor_skaeling	wh2_main_vor_settlers_coast_port_reaver
wh_occupation_decision_norsca_occupy_wh2_main_vor_settlers_coast_skeggi_wh2_main_nor_aghol	wh2_main_vor_settlers_coast_skeggi
wh_occupation_decision_norsca_occupy_wh2_main_vor_settlers_coast_skeggi_wh2_main_nor_mung	wh2_main_vor_settlers_coast_skeggi
wh_occupation_decision_norsca_occupy_wh2_main_vor_settlers_coast_skeggi_wh2_main_nor_skeggi	wh2_main_vor_settlers_coast_skeggi
wh_occupation_decision_norsca_occupy_wh2_main_vor_settlers_coast_skeggi_wh_main_nor_skaeling	wh2_main_vor_settlers_coast_skeggi
wh_occupation_decision_norsca_occupy_wh2_main_vor_settlers_coast_swamp_town_wh2_main_nor_aghol	wh2_main_vor_settlers_coast_swamp_town
wh_occupation_decision_norsca_occupy_wh2_main_vor_settlers_coast_swamp_town_wh2_main_nor_mung	wh2_main_vor_settlers_coast_swamp_town
wh_occupation_decision_norsca_occupy_wh2_main_vor_settlers_coast_swamp_town_wh2_main_nor_skeggi	wh2_main_vor_settlers_coast_swamp_town
wh_occupation_decision_norsca_occupy_wh2_main_vor_settlers_coast_swamp_town_wh_main_nor_skaeling	wh2_main_vor_settlers_coast_swamp_town
wh_occupation_decision_norsca_occupy_wh2_main_vor_southern_jungles_dawns_light_wh2_main_nor_aghol	wh2_main_vor_southern_jungles_dawns_light
wh_occupation_decision_norsca_occupy_wh2_main_vor_southern_jungles_dawns_light_wh2_main_nor_mung	wh2_main_vor_southern_jungles_dawns_light
wh_occupation_decision_norsca_occupy_wh2_main_vor_southern_jungles_dawns_light_wh2_main_nor_skeggi	wh2_main_vor_southern_jungles_dawns_light
wh_occupation_decision_norsca_occupy_wh2_main_vor_southern_jungles_dawns_light_wh_main_nor_skaeling	wh2_main_vor_southern_jungles_dawns_light
wh_occupation_decision_norsca_occupy_wh2_main_vor_southern_yvresse_elessaeli_wh2_main_nor_aghol	wh2_main_vor_southern_yvresse_elessaeli
wh_occupation_decision_norsca_occupy_wh2_main_vor_southern_yvresse_elessaeli_wh2_main_nor_mung	wh2_main_vor_southern_yvresse_elessaeli
wh_occupation_decision_norsca_occupy_wh2_main_vor_southern_yvresse_elessaeli_wh2_main_nor_skeggi	wh2_main_vor_southern_yvresse_elessaeli
wh_occupation_decision_norsca_occupy_wh2_main_vor_southern_yvresse_elessaeli_wh_main_nor_skaeling	wh2_main_vor_southern_yvresse_elessaeli
wh_occupation_decision_norsca_occupy_wh2_main_vor_southern_yvresse_shrine_of_loec_wh2_main_nor_aghol	wh2_main_vor_southern_yvresse_shrine_of_loec
wh_occupation_decision_norsca_occupy_wh2_main_vor_southern_yvresse_shrine_of_loec_wh2_main_nor_mung	wh2_main_vor_southern_yvresse_shrine_of_loec
wh_occupation_decision_norsca_occupy_wh2_main_vor_southern_yvresse_shrine_of_loec_wh2_main_nor_skeggi	wh2_main_vor_southern_yvresse_shrine_of_loec
wh_occupation_decision_norsca_occupy_wh2_main_vor_southern_yvresse_shrine_of_loec_wh_main_nor_skaeling	wh2_main_vor_southern_yvresse_shrine_of_loec
wh_occupation_decision_norsca_occupy_wh2_main_vor_straits_of_lothern_lothern_wh2_main_nor_aghol	wh2_main_vor_straits_of_lothern_lothern
wh_occupation_decision_norsca_occupy_wh2_main_vor_straits_of_lothern_lothern_wh2_main_nor_mung	wh2_main_vor_straits_of_lothern_lothern
wh_occupation_decision_norsca_occupy_wh2_main_vor_straits_of_lothern_lothern_wh2_main_nor_skeggi	wh2_main_vor_straits_of_lothern_lothern
wh_occupation_decision_norsca_occupy_wh2_main_vor_straits_of_lothern_lothern_wh_main_nor_skaeling	wh2_main_vor_straits_of_lothern_lothern
wh_occupation_decision_norsca_occupy_wh2_main_vor_the_black_coast_arnheim_wh2_main_nor_aghol	wh2_main_vor_the_black_coast_arnheim
wh_occupation_decision_norsca_occupy_wh2_main_vor_the_black_coast_arnheim_wh2_main_nor_mung	wh2_main_vor_the_black_coast_arnheim
wh_occupation_decision_norsca_occupy_wh2_main_vor_the_black_coast_arnheim_wh2_main_nor_skeggi	wh2_main_vor_the_black_coast_arnheim
wh_occupation_decision_norsca_occupy_wh2_main_vor_the_black_coast_arnheim_wh_main_nor_skaeling	wh2_main_vor_the_black_coast_arnheim
wh_occupation_decision_norsca_occupy_wh2_main_vor_the_black_flood_hag_graef_wh2_main_nor_aghol	wh2_main_vor_the_black_flood_hag_graef
wh_occupation_decision_norsca_occupy_wh2_main_vor_the_black_flood_hag_graef_wh2_main_nor_mung	wh2_main_vor_the_black_flood_hag_graef
wh_occupation_decision_norsca_occupy_wh2_main_vor_the_black_flood_hag_graef_wh2_main_nor_skeggi	wh2_main_vor_the_black_flood_hag_graef
wh_occupation_decision_norsca_occupy_wh2_main_vor_the_black_flood_hag_graef_wh_main_nor_skaeling	wh2_main_vor_the_black_flood_hag_graef
wh_occupation_decision_norsca_occupy_wh2_main_vor_the_broken_land_blacklight_tower_wh2_main_nor_aghol	wh2_main_vor_the_broken_land_blacklight_tower
wh_occupation_decision_norsca_occupy_wh2_main_vor_the_broken_land_blacklight_tower_wh2_main_nor_mung	wh2_main_vor_the_broken_land_blacklight_tower
wh_occupation_decision_norsca_occupy_wh2_main_vor_the_broken_land_blacklight_tower_wh2_main_nor_skeggi	wh2_main_vor_the_broken_land_blacklight_tower
wh_occupation_decision_norsca_occupy_wh2_main_vor_the_broken_land_blacklight_tower_wh_main_nor_skaeling	wh2_main_vor_the_broken_land_blacklight_tower
wh_occupation_decision_norsca_occupy_wh2_main_vor_the_broken_land_karond_kar_wh2_main_nor_aghol	wh2_main_vor_the_broken_land_karond_kar
wh_occupation_decision_norsca_occupy_wh2_main_vor_the_broken_land_karond_kar_wh2_main_nor_mung	wh2_main_vor_the_broken_land_karond_kar
wh_occupation_decision_norsca_occupy_wh2_main_vor_the_broken_land_karond_kar_wh2_main_nor_skeggi	wh2_main_vor_the_broken_land_karond_kar
wh_occupation_decision_norsca_occupy_wh2_main_vor_the_broken_land_karond_kar_wh_main_nor_skaeling	wh2_main_vor_the_broken_land_karond_kar
wh_occupation_decision_norsca_occupy_wh2_main_vor_the_broken_land_slavers_point_wh2_main_nor_aghol	wh2_main_vor_the_broken_land_slavers_point
wh_occupation_decision_norsca_occupy_wh2_main_vor_the_broken_land_slavers_point_wh2_main_nor_mung	wh2_main_vor_the_broken_land_slavers_point
wh_occupation_decision_norsca_occupy_wh2_main_vor_the_broken_land_slavers_point_wh2_main_nor_skeggi	wh2_main_vor_the_broken_land_slavers_point
wh_occupation_decision_norsca_occupy_wh2_main_vor_the_broken_land_slavers_point_wh_main_nor_skaeling	wh2_main_vor_the_broken_land_slavers_point
wh_occupation_decision_norsca_occupy_wh2_main_vor_the_capes_citadel_of_dusk_wh2_main_nor_aghol	wh2_main_vor_the_capes_citadel_of_dusk
wh_occupation_decision_norsca_occupy_wh2_main_vor_the_capes_citadel_of_dusk_wh2_main_nor_mung	wh2_main_vor_the_capes_citadel_of_dusk
wh_occupation_decision_norsca_occupy_wh2_main_vor_the_capes_citadel_of_dusk_wh2_main_nor_skeggi	wh2_main_vor_the_capes_citadel_of_dusk
wh_occupation_decision_norsca_occupy_wh2_main_vor_the_capes_citadel_of_dusk_wh_main_nor_skaeling	wh2_main_vor_the_capes_citadel_of_dusk
wh_occupation_decision_norsca_occupy_wh2_main_vor_the_capes_fortress_of_dawn_wh2_main_nor_aghol	wh2_main_vor_the_capes_fortress_of_dawn
wh_occupation_decision_norsca_occupy_wh2_main_vor_the_capes_fortress_of_dawn_wh2_main_nor_mung	wh2_main_vor_the_capes_fortress_of_dawn
wh_occupation_decision_norsca_occupy_wh2_main_vor_the_capes_fortress_of_dawn_wh2_main_nor_skeggi	wh2_main_vor_the_capes_fortress_of_dawn
wh_occupation_decision_norsca_occupy_wh2_main_vor_the_capes_fortress_of_dawn_wh_main_nor_skaeling	wh2_main_vor_the_capes_fortress_of_dawn
wh_occupation_decision_norsca_occupy_wh2_main_vor_the_dragon_isles_isle_of_the_crimson_skull_wh2_main_nor_aghol	wh2_main_vor_the_dragon_isles_isle_of_the_crimson_skull
wh_occupation_decision_norsca_occupy_wh2_main_vor_the_dragon_isles_isle_of_the_crimson_skull_wh2_main_nor_mung	wh2_main_vor_the_dragon_isles_isle_of_the_crimson_skull
wh_occupation_decision_norsca_occupy_wh2_main_vor_the_dragon_isles_isle_of_the_crimson_skull_wh2_main_nor_skeggi	wh2_main_vor_the_dragon_isles_isle_of_the_crimson_skull
wh_occupation_decision_norsca_occupy_wh2_main_vor_the_dragon_isles_isle_of_the_crimson_skull_wh_main_nor_skaeling	wh2_main_vor_the_dragon_isles_isle_of_the_crimson_skull
wh_occupation_decision_norsca_occupy_wh2_main_vor_the_dragon_isles_the_blood_hall_wh2_main_nor_aghol	wh2_main_vor_the_dragon_isles_the_blood_hall
wh_occupation_decision_norsca_occupy_wh2_main_vor_the_dragon_isles_the_blood_hall_wh2_main_nor_mung	wh2_main_vor_the_dragon_isles_the_blood_hall
wh_occupation_decision_norsca_occupy_wh2_main_vor_the_dragon_isles_the_blood_hall_wh2_main_nor_skeggi	wh2_main_vor_the_dragon_isles_the_blood_hall
wh_occupation_decision_norsca_occupy_wh2_main_vor_the_dragon_isles_the_blood_hall_wh_main_nor_skaeling	wh2_main_vor_the_dragon_isles_the_blood_hall
wh_occupation_decision_norsca_occupy_wh2_main_vor_the_galleons_graveyard_wh2_main_nor_aghol	wh2_main_vor_the_galleons_graveyard
wh_occupation_decision_norsca_occupy_wh2_main_vor_the_galleons_graveyard_wh2_main_nor_mung	wh2_main_vor_the_galleons_graveyard
wh_occupation_decision_norsca_occupy_wh2_main_vor_the_galleons_graveyard_wh2_main_nor_skeggi	wh2_main_vor_the_galleons_graveyard
wh_occupation_decision_norsca_occupy_wh2_main_vor_the_galleons_graveyard_wh_main_nor_skaeling	wh2_main_vor_the_galleons_graveyard
wh_occupation_decision_norsca_occupy_wh2_main_vor_the_red_rivers_zlatan_wh2_main_nor_aghol	wh2_main_vor_the_red_rivers_zlatan
wh_occupation_decision_norsca_occupy_wh2_main_vor_the_red_rivers_zlatan_wh2_main_nor_mung	wh2_main_vor_the_red_rivers_zlatan
wh_occupation_decision_norsca_occupy_wh2_main_vor_the_red_rivers_zlatan_wh2_main_nor_skeggi	wh2_main_vor_the_red_rivers_zlatan
wh_occupation_decision_norsca_occupy_wh2_main_vor_the_red_rivers_zlatan_wh_main_nor_skaeling	wh2_main_vor_the_red_rivers_zlatan
wh_occupation_decision_norsca_occupy_wh2_main_vor_the_turtle_isles_great_turtle_isle_wh2_main_nor_aghol	wh2_main_vor_the_turtle_isles_great_turtle_isle
wh_occupation_decision_norsca_occupy_wh2_main_vor_the_turtle_isles_great_turtle_isle_wh2_main_nor_mung	wh2_main_vor_the_turtle_isles_great_turtle_isle
wh_occupation_decision_norsca_occupy_wh2_main_vor_the_turtle_isles_great_turtle_isle_wh2_main_nor_skeggi	wh2_main_vor_the_turtle_isles_great_turtle_isle
wh_occupation_decision_norsca_occupy_wh2_main_vor_the_turtle_isles_great_turtle_isle_wh_main_nor_skaeling	wh2_main_vor_the_turtle_isles_great_turtle_isle
wh_occupation_decision_norsca_occupy_wh2_main_vor_the_turtle_isles_mud_isle_wh2_main_nor_aghol	wh2_main_vor_the_turtle_isles_mud_isle
wh_occupation_decision_norsca_occupy_wh2_main_vor_the_turtle_isles_mud_isle_wh2_main_nor_mung	wh2_main_vor_the_turtle_isles_mud_isle
wh_occupation_decision_norsca_occupy_wh2_main_vor_the_turtle_isles_mud_isle_wh2_main_nor_skeggi	wh2_main_vor_the_turtle_isles_mud_isle
wh_occupation_decision_norsca_occupy_wh2_main_vor_the_turtle_isles_mud_isle_wh_main_nor_skaeling	wh2_main_vor_the_turtle_isles_mud_isle
wh_occupation_decision_norsca_occupy_wh2_main_vor_the_vampire_coast_pox_marsh_wh2_main_nor_aghol	wh2_main_vor_the_vampire_coast_pox_marsh
wh_occupation_decision_norsca_occupy_wh2_main_vor_the_vampire_coast_pox_marsh_wh2_main_nor_mung	wh2_main_vor_the_vampire_coast_pox_marsh
wh_occupation_decision_norsca_occupy_wh2_main_vor_the_vampire_coast_pox_marsh_wh2_main_nor_skeggi	wh2_main_vor_the_vampire_coast_pox_marsh
wh_occupation_decision_norsca_occupy_wh2_main_vor_the_vampire_coast_pox_marsh_wh_main_nor_skaeling	wh2_main_vor_the_vampire_coast_pox_marsh
wh_occupation_decision_norsca_occupy_wh2_main_vor_the_vampire_coast_the_awakening_wh2_main_nor_aghol	wh2_main_vor_the_vampire_coast_the_awakening
wh_occupation_decision_norsca_occupy_wh2_main_vor_the_vampire_coast_the_awakening_wh2_main_nor_mung	wh2_main_vor_the_vampire_coast_the_awakening
wh_occupation_decision_norsca_occupy_wh2_main_vor_the_vampire_coast_the_awakening_wh2_main_nor_skeggi	wh2_main_vor_the_vampire_coast_the_awakening
wh_occupation_decision_norsca_occupy_wh2_main_vor_the_vampire_coast_the_awakening_wh_main_nor_skaeling	wh2_main_vor_the_vampire_coast_the_awakening
wh_occupation_decision_norsca_occupy_wh2_main_vor_the_vampire_coast_the_blood_swamps_wh2_main_nor_aghol	wh2_main_vor_the_vampire_coast_the_blood_swamps
wh_occupation_decision_norsca_occupy_wh2_main_vor_the_vampire_coast_the_blood_swamps_wh2_main_nor_mung	wh2_main_vor_the_vampire_coast_the_blood_swamps
wh_occupation_decision_norsca_occupy_wh2_main_vor_the_vampire_coast_the_blood_swamps_wh2_main_nor_skeggi	wh2_main_vor_the_vampire_coast_the_blood_swamps
wh_occupation_decision_norsca_occupy_wh2_main_vor_the_vampire_coast_the_blood_swamps_wh_main_nor_skaeling	wh2_main_vor_the_vampire_coast_the_blood_swamps
wh_occupation_decision_norsca_occupy_wh2_main_vor_the_vampire_coast_the_star_tower_wh2_main_nor_aghol	wh2_main_vor_the_vampire_coast_the_star_tower
wh_occupation_decision_norsca_occupy_wh2_main_vor_the_vampire_coast_the_star_tower_wh2_main_nor_mung	wh2_main_vor_the_vampire_coast_the_star_tower
wh_occupation_decision_norsca_occupy_wh2_main_vor_the_vampire_coast_the_star_tower_wh2_main_nor_skeggi	wh2_main_vor_the_vampire_coast_the_star_tower
wh_occupation_decision_norsca_occupy_wh2_main_vor_the_vampire_coast_the_star_tower_wh_main_nor_skaeling	wh2_main_vor_the_vampire_coast_the_star_tower
wh_occupation_decision_norsca_occupy_wh2_main_vor_tiranoc_tor_anroc_wh2_main_nor_aghol	wh2_main_vor_tiranoc_tor_anroc
wh_occupation_decision_norsca_occupy_wh2_main_vor_tiranoc_tor_anroc_wh2_main_nor_mung	wh2_main_vor_tiranoc_tor_anroc
wh_occupation_decision_norsca_occupy_wh2_main_vor_tiranoc_tor_anroc_wh2_main_nor_skeggi	wh2_main_vor_tiranoc_tor_anroc
wh_occupation_decision_norsca_occupy_wh2_main_vor_tiranoc_tor_anroc_wh_main_nor_skaeling	wh2_main_vor_tiranoc_tor_anroc
wh_occupation_decision_norsca_occupy_wh2_main_vor_western_jungles_deaths-head_monoliths_wh2_main_nor_aghol	wh2_main_vor_western_jungles_deaths-head_monoliths
wh_occupation_decision_norsca_occupy_wh2_main_vor_western_jungles_deaths-head_monoliths_wh2_main_nor_mung	wh2_main_vor_western_jungles_deaths-head_monoliths
wh_occupation_decision_norsca_occupy_wh2_main_vor_western_jungles_deaths-head_monoliths_wh2_main_nor_skeggi	wh2_main_vor_western_jungles_deaths-head_monoliths
wh_occupation_decision_norsca_occupy_wh2_main_vor_western_jungles_deaths-head_monoliths_wh_main_nor_skaeling	wh2_main_vor_western_jungles_deaths-head_monoliths
wh_occupation_decision_norsca_occupy_wh2_main_yvresse_elessaeli	wh2_main_yvresse_elessaeli
wh_occupation_decision_norsca_occupy_wh_main_blood_river_valley_barak_varr	wh_main_blood_river_valley_barak_varr
wh_occupation_decision_norsca_occupy_wh_main_bordeleaux_et_aquitaine_bordeleaux	wh_main_bordeleaux_et_aquitaine_bordeleaux
wh_occupation_decision_norsca_occupy_wh_main_carcassone_et_brionne_brionne	wh_main_carcassone_et_brionne_brionne
wh_occupation_decision_norsca_occupy_wh_main_couronne_et_languille_couronne	wh_main_couronne_et_languille_couronne
wh_occupation_decision_norsca_occupy_wh_main_couronne_et_languille_languille	wh_main_couronne_et_languille_languille
wh_occupation_decision_norsca_occupy_wh_main_death_pass_karak_drazh	wh_main_death_pass_karak_drazh
wh_occupation_decision_norsca_occupy_wh_main_eastern_badlands_karak_eight_peaks	wh_main_eastern_badlands_karak_eight_peaks
wh_occupation_decision_norsca_occupy_wh_main_eastern_border_princes_matorca	wh_main_eastern_border_princes_matorca
wh_occupation_decision_norsca_occupy_wh_main_eastern_sylvania_castle_drakenhof	wh_main_eastern_sylvania_castle_drakenhof
wh_occupation_decision_norsca_occupy_wh_main_estalia_bilbali	wh_main_estalia_bilbali
wh_occupation_decision_norsca_occupy_wh_main_estalia_magritta	wh_main_estalia_magritta
wh_occupation_decision_norsca_occupy_wh_main_estalia_tobaro	wh_main_estalia_tobaro
wh_occupation_decision_norsca_occupy_wh_main_gianthome_mountains_sjoktraken	wh_main_gianthome_mountains_sjoktraken
wh_occupation_decision_norsca_occupy_wh_main_goromandy_mountains_baersonlings_camp	wh_main_goromandy_mountains_baersonlings_camp
wh_occupation_decision_norsca_occupy_wh_main_goromandy_mountains_frozen_landing	wh_main_goromandy_mountains_frozen_landing
wh_occupation_decision_norsca_occupy_wh_main_helspire_mountains_graeling_moot	wh_main_helspire_mountains_graeling_moot
wh_occupation_decision_norsca_occupy_wh_main_helspire_mountains_serpent_jetty	wh_main_helspire_mountains_serpent_jetty
wh_occupation_decision_norsca_occupy_wh_main_helspire_mountains_the_monolith_of_katam	wh_main_helspire_mountains_the_monolith_of_katam
wh_occupation_decision_norsca_occupy_wh_main_ice_tooth_mountains_doomkeep	wh_main_ice_tooth_mountains_doomkeep
wh_occupation_decision_norsca_occupy_wh_main_ice_tooth_mountains_icedrake_fjord	wh_main_ice_tooth_mountains_icedrake_fjord
wh_occupation_decision_norsca_occupy_wh_main_ice_tooth_mountains_longship_graveyard	wh_main_ice_tooth_mountains_longship_graveyard
wh_occupation_decision_norsca_occupy_wh_main_lyonesse_lyonesse	wh_main_lyonesse_lyonesse
wh_occupation_decision_norsca_occupy_wh_main_lyonesse_mousillon	wh_main_lyonesse_mousillon
wh_occupation_decision_norsca_occupy_wh_main_mountains_of_hel_aeslings_conclave	wh_main_mountains_of_hel_aeslings_conclave
wh_occupation_decision_norsca_occupy_wh_main_mountains_of_hel_altar_of_spawns	wh_main_mountains_of_hel_altar_of_spawns
wh_occupation_decision_norsca_occupy_wh_main_mountains_of_hel_winter_pyre	wh_main_mountains_of_hel_winter_pyre
wh_occupation_decision_norsca_occupy_wh_main_mountains_of_naglfari_naglfari_plain	wh_main_mountains_of_naglfari_naglfari_plain
wh_occupation_decision_norsca_occupy_wh_main_mountains_of_naglfari_varg_camp	wh_main_mountains_of_naglfari_varg_camp
wh_occupation_decision_norsca_occupy_wh_main_nordland_dietershafen	wh_main_nordland_dietershafen
wh_occupation_decision_norsca_occupy_wh_main_ostland_norden	wh_main_ostland_norden
wh_occupation_decision_norsca_occupy_wh_main_reikland_altdorf	wh_main_reikland_altdorf
wh_occupation_decision_norsca_occupy_wh_main_southern_badlands_gronti_mingol	wh_main_southern_badlands_gronti_mingol
wh_occupation_decision_norsca_occupy_wh_main_southern_oblast_kislev	wh_main_southern_oblast_kislev
wh_occupation_decision_norsca_occupy_wh_main_the_silver_road_karaz_a_karak	wh_main_the_silver_road_karaz_a_karak
wh_occupation_decision_norsca_occupy_wh_main_the_wasteland_marienburg	wh_main_the_wasteland_marienburg
wh_occupation_decision_norsca_occupy_wh_main_tilea_luccini	wh_main_tilea_luccini
wh_occupation_decision_norsca_occupy_wh_main_tilea_miragliano	wh_main_tilea_miragliano
wh_occupation_decision_norsca_occupy_wh_main_troll_country_erengrad	wh_main_troll_country_erengrad
wh_occupation_decision_norsca_occupy_wh_main_trollheim_mountains_bay_of_blades	wh_main_trollheim_mountains_bay_of_blades
wh_occupation_decision_norsca_occupy_wh_main_trollheim_mountains_sarl_encampment	wh_main_trollheim_mountains_sarl_encampment
wh_occupation_decision_norsca_occupy_wh_main_trollheim_mountains_the_tower_of_khrakk	wh_main_trollheim_mountains_the_tower_of_khrakk
wh_occupation_decision_norsca_occupy_wh_main_vanaheim_mountains_bjornlings_gathering	wh_main_vanaheim_mountains_bjornlings_gathering
wh_occupation_decision_norsca_occupy_wh_main_vanaheim_mountains_pack_ice_bay	wh_main_vanaheim_mountains_pack_ice_bay
wh_occupation_decision_norsca_occupy_wh_main_vanaheim_mountains_troll_fjord	wh_main_vanaheim_mountains_troll_fjord
wh_occupation_decision_norsca_occupy_wh_main_western_badlands_stonemine_tower	wh_main_western_badlands_stonemine_tower
wh_occupation_decision_norsca_occupy_wh_main_western_border_princes_myrmidens	wh_main_western_border_princes_myrmidens
wh_occupation_decision_norsca_occupy_wh_main_yn_edri_eternos_the_oak_of_ages	wh_main_yn_edri_eternos_the_oak_of_ages
