Loc PackedFile	1
key	text	tooltip
rituals_display_name_wh2_dlc09_ritual_crafting_tmb_enchanted_item_brooch_of_the_great_desert	Brooch of the Great Desert	true
rituals_display_name_wh2_dlc09_ritual_tmb_ptra	Great Incantation of Ptra	true
rituals_description_wh2_dlc10_ritual_hef_lileath	{{tr:wh2_dlc10_ritual_hef_lileath_description}}	true
rituals_display_name_wh2_dlc10_dwf_ritual_armour_prospectors_mail	Prospector's Mail	true
rituals_description_wh2_dlc09_ritual_crafting_tmb_armour_armour_of_eternity	 	true
rituals_description_wh2_dlc10_dwf_ritual_armour_gate_keepers_helm	 	true
rituals_display_name_wh2_dlc09_ritual_tmb_khsar	Great Incantation of Khsar	true
rituals_description_wh2_dlc09_ritual_tmb_khsar	{{tr:wh2_dlc09_ritual_tmb_khsar_description}}	true
rituals_description_wh2_dlc11_ritual_cst_queens_cannon	{{tr:wh2_dlc11_ritual_cst_queens_cannon_description}}	true
rituals_display_name_wh2_dlc11_ritual_cst_queens_cannon	Curse of the Queenâ€™s Cannon	true
rituals_description_wh2_main_ritual_hef_hoeth	{{tr:wh2_main_ritual_hef_hoeth_description}}	true
rituals_description_wh2_main_ritual_skv_pestilence	{{tr:wh2_main_ritual_skv_pestilence_description}}	true
rituals_display_name_wh2_main_ritual_skv_pestilence	The Pestilent Scheme	true
rituals_display_name_wh2_dlc09_ritual_crafting_tmb_armour_armour_of_eternity	Armour of Eternity	true
rituals_display_name_wh2_dlc11_vmp_ritual_bloodline_awaken_lahmian_03	Lahmian	true
rituals_display_name_wh2_dlc11_vmp_ritual_bloodline_awaken_lahmian_02	Lahmian	true
rituals_display_name_wh2_dlc11_vmp_ritual_bloodline_awaken_lahmian_01	Lahmian	true
rituals_display_name_wh2_dlc09_ritual_crafting_tmb_weapon_golden_dagger	Golden Dagger	true
rituals_description_wh2_dlc09_ritual_crafting_tmb_weapon_golden_dagger	 	true
rituals_description_wh2_dlc09_ritual_crafting_tmb_enchanted_item_brooch_of_the_great_desert	 	true
rituals_description_wh2_dlc09_ritual_tmb_geheb	{{tr:wh2_dlc09_ritual_tmb_geheb_description}}	true
rituals_display_name_wh2_dlc09_ritual_tmb_geheb	Great Incantation of Geheb	true
rituals_description_wh2_main_ritual_lzd_ferocity	{{tr:wh2_main_ritual_lzd_ferocity_description}}	true
rituals_display_name_wh2_dlc09_ritual_crafting_tmb_talisman_collar_of_shakkara	Collar of Shakkara	true
rituals_description_wh2_dlc09_ritual_crafting_tmb_enchanted_item_potion_of_strength	 	true
rituals_display_name_wh2_dlc12_tehenhauin_sacrifice_tier6_sotek	Great Sacrifice of Sotek	true
rituals_description_wh2_dlc12_tehenhauin_sacrifice_tier6_sotek	\nTurns duration: 10\n\n[[col:green]][[img:icon_sotek]][[/img]]Army ability: "The Great Invocation of Sotek"\n (all armies)	true
rituals_description_wh2_dlc12_tehenhauin_sacrifice_tier2_ror_pok_hopak_cohort	\n[[col:green]][[img:icon_spawning]][[/img]]Unlocks Regiment of Renown: Pok-Hopak Cohort (Cold One Spear-Riders)	true
rituals_display_name_wh2_dlc10_dwf_ritual_talisman_dragon_slayers_fang	Dragon Slayer's Fang	true
rituals_description_wh2_dlc10_dwf_ritual_armour_prospectors_mail	 	true
rituals_display_name_wh2_dlc10_ritual_hef_lileath	Invocation of Lileath	true
rituals_display_name_wh2_dlc10_dwf_ritual_armour_rangers_cloak	Ranger's Cloak	true
rituals_description_wh2_dlc09_ritual_crafting_tmb_armour_skull_cap_of_the_moon	 	true
rituals_display_name_wh2_dlc09_ritual_crafting_tmb_armour_skull_cap_of_the_moon	Skull Cap of the Moon	true
rituals_display_name_wh2_main_ritual_lzd_ferocity	Rite of Ferocity	true
rituals_description_wh2_dlc11_vmp_ritual_bloodline_awaken_lahmian_03	{{tr:wh2_dlc11_vmp_ritual_bloodline_awaken_lahmian_description}}	true
rituals_description_wh2_dlc11_vmp_ritual_bloodline_awaken_lahmian_02	{{tr:wh2_dlc11_vmp_ritual_bloodline_awaken_lahmian_description}}	true
rituals_description_wh2_dlc11_vmp_ritual_bloodline_awaken_lahmian_01	{{tr:wh2_dlc11_vmp_ritual_bloodline_awaken_lahmian_description}}	true
rituals_display_name_wh2_dlc09_ritual_crafting_tmb_enchanted_item_potion_of_strength	Potion of Strength	true
rituals_display_name_wh2_dlc12_tehenhauin_sacrifice_tier4_ror_star_chamber_guardians	Sacrifice of Axlotl	true
rituals_description_wh2_dlc11_vmp_ritual_bloodline_awaken_necrarch_01	{{tr:wh2_dlc11_vmp_ritual_bloodline_awaken_necrarch_description}}	true
rituals_description_wh2_dlc11_vmp_ritual_bloodline_awaken_necrarch_02	{{tr:wh2_dlc11_vmp_ritual_bloodline_awaken_necrarch_description}}	true
rituals_description_wh2_dlc11_vmp_ritual_bloodline_awaken_necrarch_03	{{tr:wh2_dlc11_vmp_ritual_bloodline_awaken_necrarch_description}}	true
rituals_display_name_wh2_dlc12_lzd_tiktaqto_ritual_persistence	{{tr:wh2_dlc12_lzd_tiktaqto_ritual_persistence_title}}	true
rituals_display_name_wh2_dlc11_ritual_cst_bountiful_treasure	Curse of the Bountiful Treasure	true
rituals_description_wh2_dlc10_dwf_ritual_enchanted_item_gate_keepers_belt	 	true
rituals_display_name_wh2_dlc09_ritual_crafting_tmb_weapon_double_crescent_of_neru	Double Crescent of Neru	true
rituals_description_wh2_main_ritual_skv_ascendancy	{{tr:wh2_main_ritual_skv_ascendancy_description}}	true
rituals_display_name_wh2_main_ritual_skv_ascendancy	The Dominating Scheme	true
rituals_description_wh2_dlc09_ritual_crafting_tmb_arcane_item_scroll_of_shielding	 	true
rituals_description_wh2_dlc10_dwf_ritual_talisman_the_ankor_chain	 	true
rituals_display_name_wh2_dlc09_ritual_skv_thirteen_rictus	The Thirteenth Scheme	true
rituals_display_name_wh2_main_ritual_def_mathlann	Sacrifice to Mathlann	true
rituals_display_name_wh2_dlc09_ritual_crafting_tmb_weapon_enchanted_lapis_mace	Enchanted Lapis Mace	true
rituals_description_wh2_main_ritual_lzd_sotek	{{tr:wh2_main_ritual_lzd_sotek_description}}	true
rituals_display_name_wh2_dlc11_ritual_cst_eternal_service	Curse of Eternal Service	true
rituals_description_wh2_dlc09_ritual_crafting_tmb_armour_armour_of_the_ages	 	true
rituals_display_name_wh2_dlc10_dwf_ritual_enchanted_item_sceptre_of_stone	Sceptre of Stone	true
rituals_description_wh2_dlc10_dwf_ritual_armour_ironbeards_armour	 	true
rituals_display_name_wh2_dlc09_ritual_crafting_tmb_arcane_item_scroll_of_leeching	Scroll of Leeching	true
rituals_display_name_wh2_dlc11_vmp_ritual_bloodline_awaken_strigoi_01	Strigoi	true
rituals_display_name_wh2_dlc11_vmp_ritual_bloodline_awaken_strigoi_02	Strigoi	true
rituals_display_name_wh2_dlc11_vmp_ritual_bloodline_awaken_strigoi_03	Strigoi	true
rituals_display_name_wh2_dlc09_ritual_crafting_tmb_armour_armour_of_the_ages	Armour of the Ages	true
rituals_description_wh2_main_ritual_skv_thirteen_moulder	{{tr:wh2_main_ritual_skv_thirteen_description}}	true
rituals_description_wh2_dlc12_tehenhauin_sacrifice_tier4_ror_star_chamber_guardians	\n[[col:green]][[img:icon_spawning]][[/img]]Unlocks Regiment of Renown: Star Chamber Guardians (Temple Guard)	true
rituals_display_name_wh2_dlc09_ritual_crafting_tmb_armour_scorpion_armour	Scorpion Armour	true
rituals_display_name_wh2_dlc10_ritual_def_drakira	Sacrifice to Drakira	true
rituals_description_wh2_dlc11_ritual_cst_bountiful_treasure	{{tr:wh2_dlc11_ritual_cst_bountiful_treasure_description}}	true
rituals_display_name_wh2_dlc10_dwf_ritual_talisman_miners_lattern	Miner's Lantern	true
rituals_description_wh2_dlc09_ritual_skv_thirteen_rictus	{{tr:wh2_main_ritual_skv_thirteen_description}}	true
rituals_description_wh2_main_ritual_skv_thirteen_mors	{{tr:wh2_main_ritual_skv_thirteen_description}}	true
rituals_description_wh2_dlc11_ritual_cst_eternal_service	{{tr:wh2_dlc11_ritual_cst_eternal_service_description}}	true
rituals_description_wh2_dlc09_ritual_crafting_tmb_enchanted_item_death_mask_of_kharnut	 	true
rituals_display_name_wh2_dlc09_ritual_crafting_tmb_enchanted_item_death_mask_of_kharnut	Death Mask of Kharnut	true
rituals_description_wh2_main_ritual_def_mathlann	{{tr:wh2_main_ritual_def_mathlann_description}}	true
rituals_display_name_wh2_dlc09_ritual_crafting_tmb_arcane_item_neferras_scrolls_of_mighty_incantations	Neferra's Scrolls of Mighty Incantations	true
rituals_display_name_wh2_dlc11_vmp_ritual_bloodline_awaken_blood_dragon_01	Blood Dragon	true
rituals_display_name_wh2_dlc11_vmp_ritual_bloodline_awaken_blood_dragon_02	Blood Dragon	true
rituals_display_name_wh2_dlc11_vmp_ritual_bloodline_awaken_blood_dragon_03	Blood Dragon	true
rituals_description_wh2_dlc09_ritual_crafting_tmb_weapon_double_crescent_of_neru	 	true
rituals_description_wh2_dlc09_ritual_crafting_tmb_armour_scorpion_armour	 	true
rituals_description_wh2_dlc10_ritual_def_drakira	{{tr:wh2_dlc10_ritual_def_drakira_description}}	true
rituals_display_name_wh2_dlc12_tehenhauin_sacrifice_tier1_replenishment	Sacrifice of Qurveza	true
rituals_description_wh2_dlc12_tehenhauin_sacrifice_tier1_replenishment	\nTurns duration: 10\n\n[[col:green]][[img:icon_casualty_replenishment]][[/img]]Casualty replenishment rate: +15%\n (all armies)	true
rituals_description_wh2_dlc10_dwf_ritual_talisman_miners_lattern	 	true
rituals_display_name_wh2_dlc09_ritual_crafting_tmb_talisman_amulet_of_pha_stah	Amulet of Pha-Stah	true
rituals_description_wh2_dlc10_dwf_ritual_enchanted_item_sceptre_of_stone	 	true
rituals_display_name_wh2_dlc12_ikit_workshop_doomflayer_part_8	Spiked Armour Plates	true
rituals_display_name_wh2_dlc12_ikit_workshop_doomflayer_part_9	Aero-Die-Namics	true
rituals_display_name_wh2_dlc12_ikit_workshop_doomflayer_part_4	Propeller Knife-Blades	true
rituals_display_name_wh2_dlc12_ikit_workshop_doomflayer_part_5	Warp-Flares	true
rituals_display_name_wh2_dlc12_ikit_workshop_doomflayer_part_6	Obsidian Alloy	true
rituals_display_name_wh2_dlc12_ikit_workshop_doomflayer_part_7	Decomposing Decoys	true
rituals_display_name_wh2_dlc12_ikit_workshop_doomflayer_part_0	Micro-Reactors	true
rituals_display_name_wh2_dlc12_ikit_workshop_doomflayer_part_1	Doom Diagnostics	true
rituals_display_name_wh2_dlc12_ikit_workshop_doomflayer_part_2	Biointerfaces	true
rituals_display_name_wh2_dlc12_ikit_workshop_doomflayer_part_3	Deployable Skewer-Blades	true
rituals_description_wh2_dlc09_ritual_crafting_tmb_arcane_item_scroll_of_leeching	 	true
rituals_description_wh2_dlc11_vmp_ritual_bloodline_awaken_strigoi_01	{{tr:wh2_dlc11_vmp_ritual_bloodline_awaken_strigoi_description}}	true
rituals_description_wh2_dlc11_vmp_ritual_bloodline_awaken_strigoi_02	{{tr:wh2_dlc11_vmp_ritual_bloodline_awaken_strigoi_description}}	true
rituals_description_wh2_dlc11_vmp_ritual_bloodline_awaken_strigoi_03	{{tr:wh2_dlc11_vmp_ritual_bloodline_awaken_strigoi_description}}	true
rituals_display_name_wh2_main_ritual_skv_thirteen_moulder	The Thirteenth Scheme	true
rituals_display_name_wh2_dlc09_ritual_crafting_tmb_talisman_obsidian_lodestone	Obsidian Pendant	true
rituals_description_wh2_dlc10_dwf_ritual_armour_slayers_gauntlets	 	true
rituals_description_wh2_dlc12_ikit_workshop_warpfire_part_2	With pump designs haphazardly copied from the Dwarfs, the Warpfire Throwers will squirt their toxic filth further than ever before!	true
rituals_description_wh2_dlc12_ikit_workshop_warpfire_part_0	A double-barrelled flamethrower has two uses â€“ preventing the weapon from overheating and shooting enemies approaching from two different directions!	true
rituals_description_wh2_dlc12_ikit_workshop_warpfire_part_1	Whether handling dangerous materials in the lab or wielding chemical-spewing weaponry in the field, protective attire is always a boon!	true
rituals_display_name_wh2_dlc10_dwf_ritual_armour_miners_helm	Miner's Helm	true
rituals_display_name_wh2_dlc09_ritual_crafting_tmb_enchanted_item_potion_of_speed	Potion of Speed	true
rituals_description_wh2_main_ritual_vortex_3_skv	{{tr:wh2_main_ritual_vortex_3_skv_description}}	true
rituals_description_wh2_main_ritual_vortex_2_skv	{{tr:wh2_main_ritual_vortex_2_skv_description}}	true
rituals_description_wh2_main_ritual_vortex_1_skv	{{tr:wh2_main_ritual_vortex_1_skv_description}}	true
rituals_description_wh2_main_ritual_vortex_5_skv	{{tr:wh2_main_ritual_vortex_5_skv_description}}	true
rituals_description_wh2_main_ritual_vortex_4_skv	{{tr:wh2_main_ritual_vortex_4_skv_description}}	true
rituals_description_wh2_dlc12_ikit_workshop_jezail_part_0	The Skaven do not have great eyesight, so the sniping ability of Warplock Jezzails benefits greatly from immensely powerful telescopic scopes.	true
rituals_description_wh2_dlc12_ikit_workshop_jezail_part_1	A costly method of manufacturing bullets results in this all-purpose ammunition, effective against all types of armour whenever within killing range.	true
rituals_description_wh2_dlc12_ikit_workshop_jezail_part_2	Invisibility is seemingly a step too far, so the Engineers of Skryre shall devise something they claim is just as good.	true
rituals_display_name_wh2_dlc10_dwf_ritual_enchanted_item_old_guards_keg	Old Guard's Keg	true
rituals_description_wh2_dlc10_dwf_ritual_enchanted_item_old_guards_keg	 	true
rituals_display_name_wh2_dlc11_vmp_ritual_bloodline_awaken_von_carstein_01	Von Carstein	true
rituals_display_name_wh2_dlc11_vmp_ritual_bloodline_awaken_von_carstein_03	Von Carstein	true
rituals_display_name_wh2_dlc11_vmp_ritual_bloodline_awaken_von_carstein_02	Von Carstein	true
rituals_display_name_wh2_dlc12_ikit_workshop_warpfire_part_0	Motorised Pumps	true
rituals_display_name_wh2_dlc12_ikit_workshop_warpfire_part_1	Hazmat Fur-Suits	true
rituals_display_name_wh2_dlc12_ikit_workshop_warpfire_part_2	Gout Boosters	true
rituals_description_wh2_dlc10_dwf_ritual_armour_old_guards_armour	 	true
rituals_description_wh2_dlc10_dwf_ritual_armour_miners_helm	 	true
rituals_display_name_wh2_dlc09_ritual_crafting_tmb_armour_helmet_of_khsar	Helmet of Khsar	true
rituals_display_name_wh2_main_ritual_vortex_3_def	{{tr:wh2_main_ritual_vortex_3_def}}	true
rituals_display_name_wh2_main_ritual_vortex_3_hef	{{tr:wh2_main_ritual_vortex_3_hef}}	true
rituals_display_name_wh2_main_ritual_vortex_2_def	{{tr:wh2_main_ritual_vortex_2_def}}	true
rituals_display_name_wh2_main_ritual_vortex_2_hef	{{tr:wh2_main_ritual_vortex_2_hef}}	true
rituals_display_name_wh2_main_ritual_vortex_1_def	{{tr:wh2_main_ritual_vortex_1_def}}	true
rituals_display_name_wh2_main_ritual_vortex_1_hef	{{tr:wh2_main_ritual_vortex_1_hef}}	true
rituals_display_name_wh2_main_ritual_vortex_5_def	{{tr:wh2_main_ritual_vortex_5_def}}	true
rituals_display_name_wh2_main_ritual_vortex_5_hef	{{tr:wh2_main_ritual_vortex_5_hef}}	true
rituals_display_name_wh2_main_ritual_vortex_4_def	{{tr:wh2_main_ritual_vortex_4_def}}	true
rituals_display_name_wh2_main_ritual_vortex_4_hef	{{tr:wh2_main_ritual_vortex_4_hef}}	true
rituals_description_wh2_dlc09_ritual_crafting_tmb_enchanted_item_potion_of_speed	 	true
rituals_display_name_wh2_dlc10_dwf_ritual_talisman_slayers_ring	Slayer's Ring	true
rituals_description_wh2_dlc10_dwf_ritual_talisman_slayers_ring	 	true
rituals_description_wh2_dlc10_dwf_ritual_talisman_ironbeards_ring	 	true
rituals_display_name_wh2_dlc09_ritual_crafting_tmb_weapon_fang_of_quaph	Fang of Qu'aph	true
rituals_description_wh2_dlc09_ritual_crafting_tmb_weapon_fang_of_quaph	 	true
rituals_display_name_wh2_main_ritual_vortex_3_skv	{{tr:wh2_main_ritual_vortex_3_skv}}	true
rituals_display_name_wh2_main_ritual_vortex_2_skv	{{tr:wh2_main_ritual_vortex_2_skv}}	true
rituals_display_name_wh2_main_ritual_vortex_1_skv	{{tr:wh2_main_ritual_vortex_1_skv}}	true
rituals_display_name_wh2_main_ritual_vortex_5_skv	{{tr:wh2_main_ritual_vortex_5_skv}}	true
rituals_display_name_wh2_main_ritual_vortex_4_skv	{{tr:wh2_main_ritual_vortex_4_skv}}	true
rituals_display_name_wh2_dlc10_dwf_ritual_talisman_troll_slayers_amulet	Troll Slayer's Amulet	true
rituals_description_wh2_dlc10_dwf_ritual_talisman_troll_slayers_amulet	 	true
rituals_description_wh2_dlc10_dwf_ritual_weapon_prospectors_pickaxe	 	true
rituals_display_name_wh2_dlc10_dwf_ritual_enchanted_item_ironwardens_tankard	Ironwarden's Tankard	true
rituals_display_name_wh2_dlc09_ritual_crafting_tmb_enchanted_item_hieratic_jar	Hieratic Jar	true
rituals_display_name_wh2_dlc10_dwf_ritual_weapon_prospectors_pickaxe	Prospector's Pickaxe	true
rituals_description_wh2_dlc09_ritual_crafting_tmb_armour_helmet_of_khsar	 	true
rituals_description_wh2_main_ritual_vortex_3_def	{{tr:wh2_main_ritual_vortex_3_def_description}}	true
rituals_description_wh2_main_ritual_vortex_3_hef	{{tr:wh2_main_ritual_vortex_3_hef_description}}	true
rituals_description_wh2_main_ritual_vortex_2_def	{{tr:wh2_main_ritual_vortex_2_def_description}}	true
rituals_description_wh2_main_ritual_vortex_2_hef	{{tr:wh2_main_ritual_vortex_2_hef_description}}	true
rituals_description_wh2_main_ritual_vortex_1_def	{{tr:wh2_main_ritual_vortex_1_def_description}}	true
rituals_description_wh2_main_ritual_vortex_1_hef	{{tr:wh2_main_ritual_vortex_1_hef_description}}	true
rituals_description_wh2_main_ritual_vortex_5_def	{{tr:wh2_main_ritual_vortex_5_def_description}}	true
rituals_description_wh2_main_ritual_vortex_5_hef	{{tr:wh2_main_ritual_vortex_5_hef_description}}	true
rituals_description_wh2_main_ritual_vortex_4_def	{{tr:wh2_main_ritual_vortex_4_def_description}}	true
rituals_description_wh2_main_ritual_vortex_4_hef	{{tr:wh2_main_ritual_vortex_4_hef_description}}	true
rituals_description_wh2_dlc12_tehenhauin_sacrifice_tier1_ror_legion_of_chaqua	\n[[col:green]][[img:icon_spawning]][[/img]]Unlocks Regiment of Renown: Legion of Chaqua (Saurus Spears)	true
rituals_description_wh2_dlc10_dwf_ritual_enchanted_item_ironwardens_tankard	 	true
rituals_description_wh2_dlc10_dwf_ritual_weapon_miners_pickaxe	 	true
rituals_display_name_wh2_dlc10_dwf_ritual_weapon_miners_pickaxe	Miner's Pickaxe	true
rituals_description_wh2_dlc12_tehenhauin_sacrifice_tier3_ror_pahuax_sentinels	\n[[col:green]][[img:icon_spawning]][[/img]]Unlocks Regiment of Renown: Pahaux Sentinels (Terradon Riders)	true
rituals_display_name_wh2_dlc12_tehenhauin_sacrifice_tier1_follower	Sacrifice of Amaxon	true
rituals_display_name_wh2_dlc09_ritual_crafting_tmb_enchanted_item_elixir_of_might	Elixir of Might	true
rituals_description_wh2_dlc10_dwf_ritual_weapon_old_guards_hammer	 	true
rituals_description_wh2_dlc12_tehenhauin_sacrifice_tier1_jungle_swarm	\nTurns duration: 10\n\n[[col:green]][[img:icon_jungle_swarm]][[/img]]Army ability: "Jungle Swarm"\n (all armies)	true
rituals_description_wh2_main_ritual_vortex_1_lzd	{{tr:wh2_main_ritual_vortex_1_lzd_description}}	true
rituals_description_wh2_main_ritual_vortex_3_lzd	{{tr:wh2_main_ritual_vortex_3_lzd_description}}	true
rituals_description_wh2_main_ritual_vortex_2_lzd	{{tr:wh2_main_ritual_vortex_2_lzd_description}}	true
rituals_description_wh2_main_ritual_vortex_5_lzd	{{tr:wh2_main_ritual_vortex_5_lzd_description}}	true
rituals_description_wh2_main_ritual_vortex_4_lzd	{{tr:wh2_main_ritual_vortex_4_lzd_description}}	true
rituals_display_name_wh2_dlc12_tehenhauin_sacrifice_tier3_follower	Sacrifice of Chiquibol	true
rituals_display_name_wh2_dlc09_ritual_crafting_tmb_talisman_golden_ankhra	Golden Ankhra	true
rituals_display_name_wh2_dlc12_tehenhauin_sacrifice_tier2_follower	Sacrifice of Huanabic	true
rituals_display_name_wh2_dlc10_dwf_ritual_talisman_veterans_flask	Veteran's Flask	true
rituals_description_wh2_dlc09_ritual_crafting_tmb_enchanted_item_shroud_of_sokth	 	true
rituals_display_name_wh2_dlc10_dwf_ritual_weapon_ironbeards_axe	Ironbeard's Axe	true
rituals_description_wh2_dlc10_dwf_ritual_weapon_ironbeards_axe	 	true
rituals_description_wh2_dlc10_dwf_ritual_enchanted_item_veterans_bracers	 	true
rituals_description_wh2_dlc09_ritual_crafting_tmb_weapon_destroyer_of_eternities	 	true
rituals_display_name_wh2_dlc12_tehenhauin_sacrifice_tier4_legendary_red_crested_skink_lord	Sacrifice of Xlaxgor	true
rituals_description_wh2_dlc09_ritual_crafting_tmb_carrion	 	true
rituals_display_name_wh2_dlc12_tehenhauin_sacrifice_tier4_follower	Sacrifice of Incatol	true
rituals_description_wh2_dlc09_ritual_crafting_tmb_enchanted_item_potion_of_foolhardiness	 	true
rituals_description_wh2_dlc09_ritual_crafting_tmb_talisman_golden_eye_of_rah_nutt	 	true
rituals_display_name_wh2_main_ritual_vortex_1_lzd	{{tr:wh2_main_ritual_vortex_1_lzd}}	true
rituals_display_name_wh2_main_ritual_vortex_3_lzd	{{tr:wh2_main_ritual_vortex_3_lzd}}	true
rituals_display_name_wh2_main_ritual_vortex_2_lzd	{{tr:wh2_main_ritual_vortex_2_lzd}}	true
rituals_display_name_wh2_main_ritual_vortex_5_lzd	{{tr:wh2_main_ritual_vortex_5_lzd}}	true
rituals_display_name_wh2_main_ritual_vortex_4_lzd	{{tr:wh2_main_ritual_vortex_4_lzd}}	true
rituals_description_wh2_dlc10_dwf_ritual_weapon_slayers_axe	 	true
rituals_description_wh2_dlc09_ritual_crafting_tmb_talisman_golden_ankhra	 	true
rituals_description_wh2_dlc10_dwf_ritual_talisman_veterans_flask	 	true
rituals_display_name_wh2_dlc10_dwf_ritual_weapon_rangers_hammer	Ranger's Hammer	true
rituals_description_wh2_dlc10_dwf_ritual_weapon_rangers_hammer	 	true
rituals_description_wh2_dlc09_ritual_crafting_tmb_enchanted_item_elixir_of_might	 	true
rituals_display_name_wh2_dlc10_dwf_ritual_weapon_gate_keepers_hammer	Gatekeeper's Hammer	true
rituals_display_name_wh2_main_ritual_lzd_awakening	Rite of Awakening	true
rituals_description_wh2_main_ritual_skv_thirteen_pestilens	{{tr:wh2_main_ritual_skv_thirteen_description}}	true
rituals_display_name_wh2_main_ritual_skv_thirteen_pestilens	The Thirteenth Scheme	true
rituals_display_name_wh2_dlc10_dwf_ritual_weapon_starbreaker	Starbreaker	true
rituals_description_wh2_dlc10_dwf_ritual_enchanted_item_rangers_broach	 	true
rituals_display_name_wh2_dlc10_dwf_ritual_enchanted_item_rangers_broach	Ranger's Broach	true
rituals_display_name_wh2_dlc09_ritual_crafting_tmb_enchanted_item_potion_of_foolhardiness	Potion of Foolhardiness	true
rituals_description_wh2_dlc09_ritual_crafting_tmb_arcane_item_blue_khepra	 	true
rituals_description_wh2_dlc10_dwf_ritual_weapon_gate_keepers_hammer	 	true
rituals_display_name_wh2_dlc09_ritual_crafting_tmb_enchanted_item_vambraces_of_the_sun	Vambraces of the Sun	true
rituals_description_wh2_dlc10_dwf_ritual_weapon_starbreaker	 	true
rituals_description_wh2_dlc11_ritual_cst_sea_mist	{{tr:wh2_dlc11_ritual_cst_sea_mist_description}}	true
rituals_display_name_wh2_dlc09_ritual_crafting_tmb_enchanted_item_shroud_of_sokth	Shroud of Sokth	true
rituals_display_name_wh2_dlc10_dwf_ritual_weapon_slayers_axe	Slayer's Axe	true
rituals_display_name_wh2_dlc10_dwf_ritual_enchanted_item_horn_of_the_ancestors	Horn of the Ancestors	true
rituals_display_name_wh2_dlc10_dwf_ritual_enchanted_item_veterans_bracers	Veteran's Gauntlets	true
rituals_description_wh2_dlc10_dwf_ritual_talisman_ring_of_grimnir	 	true
rituals_display_name_wh2_dlc09_ritual_crafting_tmb_weapon_destroyer_of_eternities	Destroyer of Eternities	true
rituals_description_wh2_dlc09_ritual_crafting_tmb_talisman_collar_of_shakkara	 	true
rituals_description_wh2_dlc11_ritual_def_anath_raema	{{tr:wh2_dlc11_ritual_def_anath_raema_description}}	true
rituals_description_wh2_dlc10_dwf_ritual_talisman_ironwardens_wardstone	 	true
rituals_description_wh2_dlc09_ritual_crafting_tmb_weapon_blade_of_mourning_fire	 	true
rituals_display_name_wh2_dlc12_tehenhauin_sacrifice_tier2_ror_pok_hopak_cohort	Sacrifice of Pok-Hopak	true
rituals_description_wh2_dlc10_dwf_ritual_weapon_trollslayer_axe	 	true
rituals_description_wh2_dlc10_dwf_ritual_armour_veterans_armour	 	true
rituals_description_wh2_dlc10_dwf_ritual_talisman_dragon_slayers_fang	 	true
rituals_display_name_wh2_dlc10_dwf_ritual_talisman_rangers_pouch	Ranger's Pouch	true
rituals_description_wh2_dlc09_ritual_crafting_tmb_armour_mortuary_robes	 	true
rituals_description_wh2_dlc09_ritual_crafting_tmb_weapon_blade_of_setep	 	true
rituals_description_wh2_dlc09_ritual_crafting_tmb_enchanted_item_icon_of_rulership	 	true
rituals_display_name_wh2_dlc09_ritual_crafting_tmb_enchanted_item_icon_of_rulership	Icon of Rulership	true
rituals_description_wh2_dlc10_dwf_ritual_enchanted_item_dragon_slayers_boots	 	true
rituals_display_name_wh2_dlc10_dwf_ritual_weapon_trollslayer_axe	Troll Slayer's Axe	true
rituals_display_name_wh2_dlc09_ritual_crafting_tmb_talisman_dawnstone	Sun Scarab	true
rituals_display_name_wh2_dlc10_dwf_ritual_armour_veterans_armour	Veteran's Armour	true
rituals_description_wh2_dlc10_dwf_ritual_armour_rangers_cloak	 	true
rituals_description_wh2_dlc10_dwf_ritual_armour_alriks_plate	 	true
rituals_description_wh2_dlc10_dwf_ritual_talisman_rangers_pouch	 	true
rituals_display_name_wh2_dlc09_ritual_crafting_tmb_armour_mortuary_robes	Mortuary Robes	true
rituals_display_name_wh2_dlc10_dwf_ritual_enchanted_item_ironbeards_bracers	Ironbeard's Bracers	true
rituals_display_name_wh2_dlc09_ritual_crafting_tmb_weapon_blade_of_setep	Blade of Setep	true
rituals_description_wh2_dlc10_dwf_ritual_enchanted_item_ironbeards_bracers	 	true
rituals_description_wh2_main_ritual_intervention_1_lzd	{{tr:wh2_main_ritual_intervention_1_description}}	true
rituals_description_wh2_main_ritual_intervention_2_lzd	{{tr:wh2_main_ritual_intervention_2_description}}	true
rituals_description_wh2_main_ritual_intervention_3_lzd	 {{tr:wh2_main_ritual_intervention_3_description}}	true
rituals_display_name_wh2_main_ritual_intervention_2_lzd	Determined Intervention	true
rituals_display_name_wh2_main_ritual_intervention_3_lzd	Desperate Intervention	true
rituals_display_name_wh2_dlc09_ritual_crafting_tmb_weapon_blade_of_mourning_fire	Blade of Mourning Fire	true
rituals_display_name_wh2_main_ritual_intervention_1_lzd	Intervention	true
rituals_display_name_wh2_dlc10_dwf_ritual_talisman_ironwardens_wardstone	Ironwarden's Wardstone	true
rituals_display_name_wh2_dlc12_ikit_nuke_rite	ph	true
rituals_description_wh2_main_ritual_def_atharti	{{tr:wh2_main_ritual_def_atharti_description}}	true
rituals_description_wh2_main_ritual_skv_thirteen_eshin	{{tr:wh2_main_ritual_skv_thirteen_description}}	true
rituals_display_name_wh2_main_ritual_skv_thirteen_eshin	The Thirteenth Scheme	true
rituals_description_wh2_dlc09_ritual_tmb_ptra	{{tr:wh2_dlc09_ritual_tmb_ptra_description}}	true
rituals_display_name_wh2_dlc10_dwf_ritual_enchanted_item_dragon_slayers_boots	Dragon Slayer's Boots	true
rituals_display_name_wh2_dlc11_ritual_def_anath_raema	Sacrifice to Anath Raema	true
rituals_display_name_wh2_dlc10_dwf_ritual_armour_gate_keepers_helm	Gatekeeper's Helm	true
rituals_display_name_wh2_main_ritual_hef_hoeth	Invocation of Hoeth	true
rituals_description_wh2_dlc12_ikit_nuke_rite	ph	true
rituals_display_name_wh2_main_ritual_def_atharti	Sacrifice to Atharti	true
rituals_display_name_wh2_dlc10_dwf_ritual_weapon_dragon_slayers_axe	Dragon Slayer's Axe	true
rituals_description_wh2_dlc10_dwf_ritual_weapon_dragon_slayers_axe	 	true
rituals_display_name_wh2_dlc10_dwf_ritual_armour_alriks_plate	Alaric's Armour	true
rituals_description_wh2_dlc09_ritual_crafting_tmb_talisman_dawnstone	 	true
rituals_display_name_wh2_dlc10_dwf_ritual_enchanted_item_prospectors_spyglass	Prospector's Spyglass	true
rituals_display_name_wh2_main_ritual_skv_thirteen_mors	The Thirteenth Scheme	true
rituals_description_wh2_dlc12_tehenhauin_sacrifice_tier2_recruitment	\nTurns duration: 10\n\n[[col:green]][[img:icon_turns]][[/img]]Global recruitment duration: -1 turn for all units	true
rituals_display_name_wh2_dlc10_dwf_ritual_weapon_veterans_hammer	Veteran's Hammer	true
rituals_description_wh2_dlc12_tehenhauin_sacrifice_tier3_ror_the_umbral_tide	\n[[col:green]][[img:icon_spawning]][[/img]]Unlocks Regiment of Renown: The Umbral Tide (Salamander Hunting Pack)	true
rituals_description_wh2_dlc10_dwf_ritual_enchanted_item_slayers_belt	 	true
rituals_display_name_wh2_dlc10_dwf_ritual_talisman_gate_keepers_rat_catcher	Gatekeeper's Rat Catcher	true
rituals_description_wh2_dlc10_dwf_ritual_talisman_gate_keepers_rat_catcher	 	true
rituals_display_name_wh2_dlc10_dwf_ritual_armour_troll_slayers_hide	Troll Slayer's Hide	true
rituals_description_wh2_dlc10_dwf_ritual_armour_troll_slayers_hide	 	true
rituals_description_wh2_dlc09_ritual_crafting_tmb_arcane_item_neferras_scrolls_of_mighty_incantations	 	true
rituals_display_name_wh2_dlc09_ritual_crafting_tmb_weapon_spear_of_pakth	Spear of Pakth	true
rituals_description_wh2_dlc10_dwf_ritual_enchanted_item_troll_slayers_gauntlets	 	true
rituals_description_wh2_dlc11_vmp_ritual_bloodline_awaken_blood_dragon_01	{{tr:wh2_dlc11_vmp_ritual_bloodline_awaken_blood_dragon_description}}	true
rituals_description_wh2_dlc11_vmp_ritual_bloodline_awaken_blood_dragon_02	{{tr:wh2_dlc11_vmp_ritual_bloodline_awaken_blood_dragon_description}}	true
rituals_description_wh2_dlc11_vmp_ritual_bloodline_awaken_blood_dragon_03	{{tr:wh2_dlc11_vmp_ritual_bloodline_awaken_blood_dragon_description}}	true
rituals_display_name_wh2_dlc09_ritual_crafting_tmb_enchanted_item_potion_of_toughness	Potion of Toughness	true
rituals_description_wh2_dlc12_ikit_workshop_gatling_part_2	The hotter a Ratling Gun gets, the faster it can fire, but the more liable it is to overheat. Coolant solves this problem.	true
rituals_description_wh2_dlc12_ikit_workshop_gatling_part_1	This new-fangled invention for ammunition replenishment enables on-the-spot conversion of metal scraps into bullets.	true
rituals_description_wh2_dlc12_ikit_workshop_gatling_part_0	Research into new bullet designs yields interesting results; all that's needed now is an assembly line of slaves to painstakingly mass-produce them.	true
rituals_display_name_wh2_main_ritual_skv_thirteen_skyre	The Thirteenth Scheme	true
rituals_display_name_wh2_dlc12_ikit_workshop_gatling_part_1	On-Board Waste Compactor	true
rituals_description_wh2_main_ritual_skv_thirteen_skyre	{{tr:wh2_main_ritual_skv_thirteen_description}}	true
rituals_display_name_wh2_dlc12_ikit_workshop_gatling_part_0	Claw-Crafted Bullets	true
rituals_display_name_wh2_dlc12_ikit_workshop_gatling_part_2	Ratling Coolant	true
rituals_description_wh2_dlc09_ritual_crafting_tmb_weapon_spear_of_pakth	 	true
rituals_display_name_wh2_dlc10_dwf_ritual_enchanted_item_troll_slayers_gauntlets	Troll Slayer's Gauntlets	true
rituals_description_wh2_dlc10_dwf_ritual_weapon_ironwardens_hammer	 	true
rituals_display_name_wh2_dlc10_dwf_ritual_weapon_ironwardens_hammer	Ironwarden's Hammer	true
rituals_description_wh2_dlc09_ritual_crafting_tmb_talisman_amulet_of_pha_stah	 	true
rituals_description_wh2_main_ritual_intervention_2_skv	{{tr:wh2_main_ritual_intervention_2_description}}	true
rituals_description_wh2_main_ritual_intervention_3_skv	 {{tr:wh2_main_ritual_intervention_3_description}}	true
rituals_description_wh2_main_ritual_intervention_1_skv	{{tr:wh2_main_ritual_intervention_1_description}}	true
rituals_display_name_wh2_main_ritual_intervention_1_skv	Intervention	true
rituals_display_name_wh2_main_ritual_intervention_2_skv	Determined Intervention	true
rituals_display_name_wh2_main_ritual_intervention_3_skv	Desperate Intervention	true
rituals_description_wh2_dlc12_ikit_workshop_doomflayer_part_8	Rigorous testing has shown that penetrating these reinforced, serrated armour plates is near-impossible without damaging the penetrating weapon.	true
rituals_description_wh2_dlc12_ikit_workshop_doomflayer_part_9	An iron ball of death is more effective the less it is dragged down by resistance â€“ be that by wind, blood, flesh, or bone!	true
rituals_description_wh2_dlc12_ikit_workshop_doomflayer_part_4	Equipping a Doom-flayer with a set of motorized whirling blades gives it the ability to deflect incoming projectiles.	true
rituals_description_wh2_dlc12_ikit_workshop_doomflayer_part_5	Warpstone-powered incendiary devices triggered around the Doom-flayer are effective countermeasures against anything thrown at them... which is typically an awful lot!	true
rituals_description_wh2_dlc12_ikit_workshop_doomflayer_part_6	The secret recipe for this black stone alloy results in blades that get sharper and sharper the more they cut and slash.	true
rituals_description_wh2_dlc12_ikit_workshop_doomflayer_part_7	Similar to the Doomwheel's 'Meat Shields' technique, putrid flesh is used to assault the enemyâ€™s senses as a method of distraction.	true
rituals_description_wh2_dlc12_ikit_workshop_doomflayer_part_0	Nicknamed "Doomballs", these dangerous micro-replicas of the Doomsphere provide Doom-flayers with a potent but unpredictable power source.	true
rituals_description_wh2_dlc12_ikit_workshop_doomflayer_part_1	Mechanical flaying is a complex business; a Doom-flayerâ€™s parts need constant analysis to stay in sync and to maximise power.	true
rituals_description_wh2_dlc12_ikit_workshop_doomflayer_part_2	Allows the Warlock Masters to 'plug-in' to their Doom-flayers, redirecting some of the Warp-energy to their own bodies.	true
rituals_description_wh2_dlc12_ikit_workshop_doomflayer_part_3	What happens when you stick foldable blades onto the ones you already have? An inescapable maelstrom of screaming, agonising, flaying death! Ouch!	true
rituals_description_wh2_dlc10_dwf_ritual_weapon_veterans_hammer	 	true
rituals_description_wh2_main_ritual_intervention_2_def	{{tr:wh2_main_ritual_intervention_2_description}}	true
rituals_description_wh2_main_ritual_intervention_2_hef	{{tr:wh2_main_ritual_intervention_2_description}}	true
rituals_description_wh2_main_ritual_intervention_3_def	 {{tr:wh2_main_ritual_intervention_3_description}}	true
rituals_description_wh2_main_ritual_intervention_3_hef	 {{tr:wh2_main_ritual_intervention_3_description}}	true
rituals_description_wh2_main_ritual_intervention_1_def	{{tr:wh2_main_ritual_intervention_1_description}}	true
rituals_description_wh2_main_ritual_intervention_1_hef	{{tr:wh2_main_ritual_intervention_1_description}}	true
rituals_display_name_wh2_main_ritual_intervention_1_def	Intervention	true
rituals_display_name_wh2_main_ritual_intervention_1_hef	Intervention	true
rituals_display_name_wh2_main_ritual_intervention_2_def	Determined Intervention	true
rituals_display_name_wh2_main_ritual_intervention_2_hef	Determined Intervention	true
rituals_display_name_wh2_main_ritual_intervention_3_def	Desperate Intervention	true
rituals_display_name_wh2_main_ritual_intervention_3_hef	Desperate Intervention	true
rituals_description_wh2_dlc10_dwf_ritual_armour_ironwardens_shield	 	true
rituals_display_name_wh2_dlc10_dwf_ritual_armour_ironwardens_shield	Ironwarden's Shield	true
rituals_display_name_wh2_dlc11_vmp_ritual_bloodline_awaken_necrarch_01	Necrarch	true
rituals_display_name_wh2_dlc11_vmp_ritual_bloodline_awaken_necrarch_02	Necrarch	true
rituals_display_name_wh2_dlc11_vmp_ritual_bloodline_awaken_necrarch_03	Necrarch	true
rituals_description_wh2_dlc12_lzd_tiktaqto_ritual_persistence	{{tr:wh2_dlc12_lzd_tiktaqto_ritual_persistence_description}}	true
rituals_description_wh2_main_ritual_def_hekarti	{{tr:wh2_main_ritual_def_hekarti_description}}	true
rituals_display_name_wh2_dlc10_dwf_ritual_enchanted_item_gate_keepers_belt	Gatekeeper's Belt	true
rituals_display_name_wh2_main_ritual_lzd_primeval_glory	Rite of Primeval Glory	true
rituals_description_wh2_dlc09_ritual_crafting_tmb_enchanted_item_potion_of_toughness	 	true
rituals_description_wh2_main_ritual_lzd_primeval_glory	{{tr:wh2_main_ritual_lzd_primeval_glory_description}}	true
rituals_display_name_wh2_dlc12_ikit_workshop_nuke_part_5	Chemical Warp-Heads	true
rituals_display_name_wh2_dlc12_ikit_workshop_nuke_part_4	Refined Warpstone	true
rituals_display_name_wh2_dlc12_ikit_workshop_nuke_part_3	Kill-Experiment Field	true
rituals_display_name_wh2_dlc12_ikit_workshop_nuke_part_2	Toxic Waste Salvage	true
rituals_display_name_wh2_dlc12_ikit_workshop_nuke_part_1	Under-Empire Silos	true
rituals_display_name_wh2_dlc12_ikit_workshop_nuke_part_0	Warp-Power Plant	true
rituals_description_wh2_main_ritual_hef_asuryan	{{tr:wh2_main_ritual_hef_asuryan_description}}	true
rituals_display_name_wh2_dlc10_dwf_ritual_weapon_elfbane	Elfbane	true
rituals_display_name_wh2_dlc09_ritual_crafting_tmb_arcane_item_scroll_of_shielding	Scroll of Shielding	true
rituals_display_name_wh2_dlc10_dwf_ritual_talisman_the_ankor_chain	The Ankor Chain	true
rituals_description_wh2_dlc10_dwf_ritual_enchanted_item_prospectors_spyglass	 	true
rituals_display_name_wh2_dlc10_dwf_ritual_enchanted_item_slayers_belt	Slayer's Belt	true
rituals_description_wh2_dlc09_ritual_crafting_tmb_weapon_enchanted_lapis_mace	 	true
rituals_display_name_wh2_dlc12_tehenhauin_sacrifice_tier2_recruitment	Sacrifice of Gwangee	true
rituals_display_name_wh2_main_ritual_lzd_sotek	Rite of Sotek	true
rituals_display_name_wh2_dlc12_tehenhauin_sacrifice_tier3_ror_the_umbral_tide	Sacrifice of Oyxl	true
rituals_display_name_wh2_main_ritual_hef_asuryan	Invocation of Asuryan	true
rituals_description_wh2_dlc10_dwf_ritual_weapon_elfbane	 	true
rituals_display_name_wh2_dlc10_dwf_ritual_armour_ironbeards_armour	Ironbeard's Armour	true
rituals_display_name_wh2_main_ritual_def_hekarti	Sacrifice to Hekarti	true
rituals_description_wh2_dlc12_ikit_workshop_nuke_part_5	Give the Doomrockets an extra 'kick'. The enemyâ€™s going to feel this one!	true
rituals_description_wh2_dlc12_ikit_workshop_nuke_part_4	Warpstone ore is quite unusable in its crude state, needing processes of separation and purification before being in any way useful.	true
rituals_description_wh2_dlc12_ikit_workshop_nuke_part_1	In the filthy caverns of the Under-Empire, the potential for mass destruction shall silently sit, stockpiled until the moment of explosive grandeur.	true
rituals_description_wh2_dlc12_ikit_workshop_nuke_part_0	A giant labyrinth of pumps, valves, turbines, and generators, all submerged in an ominous cloud of green steam. Here, Warpstoneâ€™s power is harvested.	true
rituals_description_wh2_dlc12_ikit_workshop_nuke_part_3	Test subjects are prodded, stabbed, shot, zapped, burnt, dematerialised â€“ you name it. If it causes pain or death, it probably happens here.	true
rituals_description_wh2_dlc12_ikit_workshop_nuke_part_2	Devising new 'waste-not, want-not' methods will make even the most degraded or poisonous waste materials processable for Warp-fuel production.	true
rituals_display_name_wh2_dlc10_dwf_ritual_talisman_ironbeards_ring	Ironbeard's Ring	true
rituals_description_wh2_dlc12_tehenhauin_sacrifice_tier1_banner	\nTurns duration: 10\n\n[[col:green]][[img:armour]][[/img]]Armour: +10 for all units\n (all armies)	true
rituals_description_wh2_dlc12_tehenhauin_sacrifice_tier2_banner	\n[[col:green]]Unlocks a random Banner	true
rituals_description_wh2_dlc12_tehenhauin_sacrifice_tier3_banner	\nTurns duration: 10\n\n[[col:green]][[img:growth]][[/img]]Growth: +15\n (all provinces)	true
rituals_description_wh2_dlc12_tehenhauin_sacrifice_tier4_banner	\nTurns duration: 10\n\n[[col:green]][[img:icon_religion]][[/img]]Untainted: +8\n (all regions)	true
rituals_display_name_wh2_main_ritual_hef_isha	Invocation of Isha	true
rituals_display_name_wh2_dlc09_ritual_crafting_tmb_armour_armour_of_dawn	Armour of Dawn	true
rituals_description_wh2_dlc12_ikit_workshop_doomwheel_part_8	Blending metallurgy, alchemy, and sorcery results in the best armour you can possibly forge. Smells toxic, but what doesn't on a Doomwheel?	true
rituals_description_wh2_dlc12_ikit_workshop_doomwheel_part_9	Tying up some slaves and suspending them around the Doomwheel provides some level of grisly protection â€“ just keep the flesh fresh!	true
rituals_description_wh2_dlc12_ikit_workshop_doomwheel_part_4	Using these curiously-designed parts, power transfer can occur at impossible speeds, leading to even more devastating zappers.	true
rituals_description_wh2_dlc12_ikit_workshop_doomwheel_part_5	Fitted to Doomwheel bolt-throwers, these allow Warp-energy to be briefly stored before firing, making for more concentrated attacks.	true
rituals_description_wh2_dlc12_ikit_workshop_doomwheel_part_6	Smells like rat-bile mixed with crude oil, but few things are better for keeping engine parts moving â€“ just donâ€™t ask how itâ€™s made.	true
rituals_description_wh2_dlc12_ikit_workshop_doomwheel_part_7	These parts have long been scavenged from Dwarf-things' Gyrocopters â€“ with modifications, they can also afford the Doomwheels more killing-mileage!	true
rituals_description_wh2_dlc12_ikit_workshop_doomwheel_part_0	These components allow a cyclical energy transfer between the scurrying rats powering the Doomwheel and its Warpstone generator, leading to incredible power surges.	true
rituals_description_wh2_dlc12_ikit_workshop_doomwheel_part_1	Adding these to a Doomwheel's Warpstone generator allows a Warlock Master to overcharge its power output to unpredictable levels.	true
rituals_description_wh2_dlc12_ikit_workshop_doomwheel_part_2	A portable power system used for keeping other Doomwheel systems operational when the scurrying rats are at full automotive capacity.	true
rituals_description_wh2_dlc12_ikit_workshop_doomwheel_part_3	Allows Warp Lightning bolts to be split with a stunning 200% efficiency, using a technique likely 'acquired' from the Luminarks of Nuln.	true
rituals_display_name_wh2_dlc10_dwf_ritual_armour_dragon_slayers_scale	Dragon Slayer's Scales	true
rituals_description_wh2_dlc09_ritual_crafting_tmb_enchanted_item_hieratic_jar	 	true
rituals_display_name_wh2_dlc10_dwf_ritual_talisman_old_guards_tankard	Old Guard's Tankard	true
rituals_description_wh2_dlc09_ritual_crafting_tmb_armour_armour_of_dawn	 	true
rituals_description_wh2_dlc09_ritual_crafting_tmb_necropolis_knights	 	true
rituals_display_name_wh2_dlc12_tehenhauin_sacrifice_tier1_ror_legion_of_chaqua	Sacrifice of Chaqua	true
rituals_description_wh2_dlc10_dwf_ritual_enchanted_item_miners_drinking_horn	 	true
rituals_description_wh2_dlc09_ritual_crafting_tmb_nehekhara_horsemen	 	true
rituals_description_wh2_dlc09_ritual_crafting_tmb_arcane_item_power_scroll	 	true
rituals_display_name_wh2_dlc09_ritual_crafting_tmb_arcane_item_power_scroll	Scroll of Power	true
rituals_display_name_wh2_dlc12_tehenhauin_sacrifice_tier3_ror_pahuax_sentinels	Sacrifice of Pahaux	true
rituals_display_name_wh2_dlc12_tehenhauin_sacrifice_tier1_banner	Sacrifice of Xahutec	true
rituals_display_name_wh2_dlc12_tehenhauin_sacrifice_tier2_banner	Sacrifice of Quetza	true
rituals_display_name_wh2_dlc12_tehenhauin_sacrifice_tier3_banner	Sacrifice of Qu'ittax	true
rituals_display_name_wh2_dlc12_tehenhauin_sacrifice_tier4_banner	Sacrifice of Aymara	true
rituals_description_wh2_dlc10_dwf_ritual_armour_starmetal_plate	 	true
rituals_description_wh2_dlc09_ritual_crafting_tmb_talisman_obsidian_lodestone	 	true
rituals_display_name_wh2_dlc12_ikit_workshop_doomwheel_part_4	Superconductors	true
rituals_display_name_wh2_dlc12_ikit_workshop_doomwheel_part_5	Warp-Capacitors	true
rituals_display_name_wh2_dlc12_ikit_workshop_doomwheel_part_6	Skavenslave Grease	true
rituals_display_name_wh2_dlc12_ikit_workshop_doomwheel_part_7	Gyro-Cogs	true
rituals_display_name_wh2_dlc12_ikit_workshop_doomwheel_part_0	Warpstone Dynamos	true
rituals_display_name_wh2_dlc12_ikit_workshop_doomwheel_part_1	Warp-Spark Plugs	true
rituals_display_name_wh2_dlc12_ikit_workshop_doomwheel_part_2	Micro-Warp-Batteries	true
rituals_display_name_wh2_dlc12_ikit_workshop_doomwheel_part_3	Splitter Prisms	true
rituals_display_name_wh2_dlc12_ikit_workshop_doomwheel_part_8	Warpstone Alloys	true
rituals_display_name_wh2_dlc12_ikit_workshop_doomwheel_part_9	Meat Shields	true
rituals_display_name_wh2_dlc10_dwf_ritual_armour_slayers_gauntlets	Slayer's Bracers	true
rituals_description_wh2_dlc10_dwf_ritual_armour_dragon_slayers_scale	 	true
rituals_display_name_wh2_dlc12_tehenhauin_sacrifice_tier2_ror_colossadon_hunters	Sacrifice of Mal'liente	true
rituals_description_wh2_dlc09_ritual_crafting_tmb_armour_shield_of_ptra	 	true
rituals_description_wh2_main_ritual_hef_isha	{{tr:wh2_main_ritual_hef_isha_description}}	true
rituals_display_name_wh2_dlc09_ritual_tmb_tahoth	Great Incantation of Tahoth	true
rituals_description_wh2_dlc12_tehenhauin_sacrifice_tier5_ror_the_thunderous_one	\n[[col:green]][[img:icon_spawning]][[/img]]Unlocks Regiment of Renown: The Thunderous One (Ancient Stegadon)	true
rituals_display_name_wh2_dlc12_ikit_workshop_jezail_part_0	Rat-Eye Scopes	true
rituals_display_name_wh2_dlc12_ikit_workshop_jezail_part_1	Craven Rounds	true
rituals_display_name_wh2_dlc12_ikit_workshop_jezail_part_2	Ghillie Fur-Suits	true
rituals_description_wh2_dlc11_vmp_ritual_bloodline_awaken_von_carstein_01	{{tr:wh2_dlc11_vmp_ritual_bloodline_awaken_von_carstein_description}}	true
rituals_description_wh2_dlc11_vmp_ritual_bloodline_awaken_von_carstein_03	{{tr:wh2_dlc11_vmp_ritual_bloodline_awaken_von_carstein_description}}	true
rituals_description_wh2_dlc11_vmp_ritual_bloodline_awaken_von_carstein_02	{{tr:wh2_dlc11_vmp_ritual_bloodline_awaken_von_carstein_description}}	true
rituals_display_name_wh2_dlc09_ritual_crafting_tmb_armour_shield_of_ptra	Shield of Ptra	true
rituals_description_wh2_dlc12_tehenhauin_sacrifice_tier2_ror_colossadon_hunters	\n[[col:green]][[img:icon_spawning]][[/img]]Unlocks Regiment of Renown: Colossadon Hunters (Ripperdactyl Riders)	true
rituals_display_name_wh2_dlc10_dwf_ritual_armour_old_guards_armour	Old Guard's Armour	true
rituals_display_name_wh2_main_ritual_def_khaine	Sacrifice to Khaine	true
rituals_description_wh2_main_ritual_def_khaine	{{tr:wh2_main_ritual_def_khaine_description}}	true
rituals_description_wh2_dlc09_ritual_tmb_tahoth	{{tr:wh2_dlc09_ritual_tmb_tahoth_description}}	true
rituals_display_name_wh2_dlc12_tehenhauin_sacrifice_tier5_ror_the_thunderous_one	Sacrifice of Capac	true
rituals_description_wh2_dlc10_ritual_hef_morai_heg	{{tr:wh2_dlc10_ritual_hef_morai_heg_description}}	true
rituals_display_name_wh2_dlc10_ritual_hef_morai_heg	Invocation of Morai-Heg	true
rituals_display_name_wh2_dlc10_dwf_ritual_armour_starmetal_plate	Starmetal Plate	true
rituals_display_name_wh2_dlc09_ritual_crafting_tmb_necropolis_knights	Venom Knights of Asaph (Necropolis Knights)	true
rituals_description_wh2_dlc10_dwf_ritual_talisman_old_guards_tankard	 	true
rituals_display_name_wh2_dlc10_dwf_ritual_enchanted_item_miners_drinking_horn	Miner's Drinking Horn	true
rituals_display_name_wh2_dlc09_ritual_crafting_tmb_nehekhara_horsemen	Storm Riders of Khsar (Nehekhara Horsemen)	true
rituals_display_name_wh2_dlc09_ritual_crafting_tmb_arcane_item_enkhils_kanopi	Enkhil's Kanopi	true
rituals_display_name_wh2_dlc10_dwf_ritual_talisman_prospectors_charge	Prospector's Charge	true
rituals_description_wh2_dlc09_ritual_crafting_tmb_nehekhara_warriors	 	true
rituals_description_wh2_main_ritual_lzd_awakening	{{tr:wh2_main_ritual_lzd_awakening_description}}	true
rituals_description_wh2_dlc09_ritual_crafting_tmb_army_capacity	 	true
rituals_display_name_wh2_dlc09_ritual_crafting_tmb_arcane_item_blue_khepra	Blue Khepra	true
rituals_description_wh2_dlc09_ritual_crafting_tmb_weapon_crook_and_flail_of_radiance	 	true
rituals_description_wh2_dlc09_ritual_crafting_tmb_enchanted_item_vambraces_of_the_sun	 	true
rituals_display_name_wh2_dlc09_ritual_crafting_tmb_army_capacity	A New Dynasty	true
rituals_display_name_wh2_main_ritual_skv_doooom	The Scheme of DOOOOM!	true
rituals_description_wh2_main_ritual_skv_doooom	{{tr:wh2_main_ritual_skv_doooom_description}}	true
rituals_description_wh2_main_ritual_hef_vaul	{{tr:wh2_main_ritual_hef_vaul_description}}	true
rituals_display_name_wh2_dlc09_ritual_crafting_tmb_weapon_blade_of_antarhak	Blade of Antarhak	true
rituals_description_wh2_dlc09_ritual_crafting_tmb_weapon_blade_of_antarhak	 	true
rituals_display_name_wh2_dlc11_ritual_cst_sea_mist	Curse of the Sea Mist	true
rituals_description_wh2_dlc10_dwf_ritual_enchanted_item_horn_of_the_ancestors	 	true
rituals_display_name_wh2_dlc10_dwf_ritual_talisman_ring_of_grimnir	Ring of Grimnir	true
rituals_display_name_wh2_dlc12_tehenhauin_sacrifice_tier1_ror_cohort_of_sotek	Sacrifice of Gwakmol	true
rituals_display_name_wh2_dlc09_ritual_crafting_tmb_nehekhara_warriors	Usirian's Legion of the Netherworld (Nehekhara Warriors)	true
rituals_description_wh2_dlc12_tehenhauin_sacrifice_tier1_follower	\nTurns duration: 10\n\n[[col:green]][[img:icon_morale]][[/img]]Leadership: +5 for Skink units\n (all armies)	true
rituals_display_name_wh2_dlc10_dwf_ritual_weapon_old_guards_hammer	Old Guard's Hammer	true
rituals_display_name_wh2_dlc12_tehenhauin_sacrifice_tier1_jungle_swarm	Sacrifice of Xuhua	true
rituals_description_wh2_dlc10_dwf_ritual_talisman_prospectors_charge	 	true
rituals_description_wh2_dlc09_ritual_crafting_tmb_arcane_item_enkhils_kanopi	 	true
rituals_description_wh2_dlc12_tehenhauin_sacrifice_tier3_follower	\nTurns duration: 10\n\n[[col:green]] [[img:public_order]][[/img]]Public order: +5\n (all provinces)	true
rituals_description_wh2_dlc12_tehenhauin_sacrifice_tier2_follower	\n[[col:green]]Unlocks a random Follower	true
rituals_display_name_wh2_dlc09_ritual_crafting_tmb_weapon_inscribed_khopesh	Inscribed Khopesh	true
rituals_description_wh2_dlc09_ritual_crafting_tmb_weapon_inscribed_khopesh	 	true
rituals_display_name_wh2_main_ritual_hef_vaul	Invocation of Vaul	true
rituals_description_wh2_dlc12_tehenhauin_sacrifice_tier1_ror_cohort_of_sotek	\n[[col:green]][[img:icon_spawning]][[/img]]Unlocks Regiment of Renown: Cohort of Sotek (Red Crested Skinks)	true
rituals_description_wh2_dlc12_tehenhauin_sacrifice_tier4_legendary_red_crested_skink_lord	\n[[col:green]][[img:icon_general]][[/img]]Unlocks a unique powerful Red Crested Skink Chief	true
rituals_display_name_wh2_dlc09_ritual_crafting_tmb_carrion	The Flock of Djaf (Carrions)	true
rituals_description_wh2_dlc12_tehenhauin_sacrifice_tier4_follower	\nTurns duration: 10\n\n[[col:green]][[img:icon_experience]][[/img]]Recruit rank: +2 for all units\n (all armies)	true
rituals_description_wh2_dlc09_ritual_crafting_tmb_enchanted_item_ouroboros	 	true
rituals_display_name_wh2_dlc09_ritual_crafting_tmb_enchanted_item_ouroboros	Ouroboros	true
rituals_display_name_wh2_dlc09_ritual_crafting_tmb_weapon_crook_and_flail_of_radiance	Crook & Flail of Radiance	true
rituals_display_name_wh2_dlc09_ritual_crafting_tmb_talisman_golden_eye_of_rah_nutt	Golden Eye of Rah-Nutt	true
