Loc PackedFile	1
key	text	tooltip
unit_description_short_texts_text_wh2_main_unit_short_text_skv_veh_doomwheel	Careening across the battlefield, smashing everything on contact and incinerating anything too close with bolts of savage Warpstone lightning.	true
unit_description_short_texts_text_wh2_dlc09_tmb_mon_sepulchral_stalkers	These sentinels mark the borders of the Tomb Kings' realm, submerged in the sand, waiting to strike at the unsuspecting.	true
unit_description_short_texts_text_wh_main_unit_short_text_dwf_lord	In battle, the Dwarfen Lord gets lost in the melee with hammer in hand, strong as a dozen Dwarfen soldiers.	true
unit_description_short_texts_text_wh_dlc08_unit_short_text_nor_marauder_hunters	The harshest of wildernesses creates the most brutal of hunters.	true
unit_description_short_texts_text_wh_dlc08_unit_short_text_nor_marauder_chariot	With spinning scythes and a spike-laden chassis, this chariot causes maximum bloodshed with its devastating charge. 	true
unit_description_short_texts_text_wh2_dlc12_unit_short_text_skv_inf_ratling_gun_ror_0	Keep your mouth shut and your head down if you want to live.	true
unit_description_short_texts_text_wh2_dlc09_tmb_inf_skeleton_warriors	The Undead devotees of the Tomb Kings are risen again, unswervingly loyal to their liege.	true
unit_description_short_texts_text_wh2_dlc09_tmb_inf_skeleton_spearmen	Spears extend, like gnarled and sharpened bones, held firmly in place by their deathly-grip.	true
unit_description_short_texts_text_wh_dlc07_unit_short_text_brt_prophetess_life	These spellcasters use the Lore of Life to protect friendly troops, yet frustrate and confound enemies.	true
unit_description_short_texts_text_wh2_dlc09_tmb_mon_necrosphinx	The living are scythed down as these nightmarish beasts glide and bound amongst their helpless, terrified prey.	true
unit_description_short_texts_text_wh2_main_unit_short_text_lzd_cav_cold_ones_1	Those able to ride Cold Ones charge headlong into enemy lines, thrashing with crude but effective clubs.	true
unit_description_short_texts_text_wh2_main_unit_short_text_lzd_cav_cold_ones_0	Those able to ride Cold Ones charge headlong into enemy lines, thrashing with crude but effective clubs.	true
unit_description_short_texts_text_wh_pro04_unit_short_text_bst_inf_ungor_spearmen_ror	The nimblest Ungors of the herds, originating from one of the most ancient woods in the Old World.	true
unit_description_short_texts_text_wh2_dlc11_unit_short_text_cst_cav_knights_of_the_realm	These eminent horsemen were previously entrusted to defend Bretonnian lands to their dying breath – an event that has long past.	true
unit_description_short_texts_text_wh2_main_unit_short_text_lzd_mon_kroxigors	The perfect shock troop smashes into enemy lines, devastating their confidence by inflicting many casualties.	true
unit_description_short_texts_text_wh_dlc04_unit_short_text_emp_royal_altdorf_gryphites	Majesty and power personified, their devastating charge exemplifying their regal brilliance.	true
unit_description_short_texts_text_wh_dlc08_unit_short_text_nor_wulfrik	The Eternal Challenger is bound to a lifetime of constant duelling and violent killing.	true
unit_description_short_texts_text_wh2_main_unit_short_text_skv_cha_assassin	What cannot be solved with poisons and subterfuge from afar, is dealt with up close with twin blades of death.	true
unit_description_short_texts_text_wh_dlc06_unit_short_text_grn_da_rusty_arrers	A piercing arrow is debilitating enough, yet all manner of filth and corrosion is loosed from their crude bows.	true
unit_description_short_texts_text_wh2_dlc09_tmb_cha_tomb_prince	Entombed alongside their mighty sovereign, Nehekhara's deathless princes are reawakened to command the Undead legions.	true
unit_description_short_texts_text_wh_main_unit_short_text_vmp_terrorgheist	The diving Terrorgheist, with a terrifying scream, seeds death and havoc amongst its enemies.	true
unit_description_short_texts_text_wh2_dlc12_unit_short_text_skv_art_warp_lightning_cannon_ror_0	If you're facing Ikit's cannon crew, chances are you're already dead!	true
unit_description_short_texts_text_wh_dlc05_unit_short_text_wef_ancient_treemen	Before the Elves there were the Ancients. If woken from their slumber, it is always to defend the forest.	true
unit_description_short_texts_text_wh_dlc05_unit_short_text_wef_treemen	A powerful flurry of knots and branches, striking out in the midst of the battle; the will of the forest made real.	true
unit_description_short_texts_text_wh_dlc06_unit_short_text_grn_broken_tusk_mob	The biggest, nastiest, most bad-tempered of Big 'Uns, this elite mob will stomp ya and jump about on da bitz afterwards.	true
unit_description_short_texts_text_wh2_main_unit_short_text_skv_mon_hell_pit_abomination_boss	The Hellbeast’s belly bulges with thousands of screeching rats, frantically scratching at bloody walls to escape their fleshy prison. 	true
unit_description_short_texts_text_wh2_main_unit_short_text_skv_cha_warlock_engineer	Marching to war with magical machinations; outrageous and heretical, but most of all deadly.	true
unit_description_short_texts_text_wh_dlc03_unit_short_text_bst_gorebull	Gorebulls do not hesitate, smashing into enemy ranks with overwhelming power.	true
unit_description_short_texts_text_wh2_dlc11_unit_short_text_cst_inf_deck_gunners	Zombie pirate crews love dragging a big gun into a fight, no matter how unwieldy it might be!	true
unit_description_short_texts_text_wh2_main_unit_short_text_lzd_cav_terradon_riders_blessed_1	Fleet Terradons marked for greatness by the Old Ones. 	true
unit_description_short_texts_text_wh_dlc06_unit_short_text_dwf_rangers_great_weapons	Stealthy and steadfast, these redoubtable Rangers carry both throwing and great axes – the latter for dealing with the more ‘imposing’ opponents.	true
unit_description_short_texts_text_wh_dlc07_unit_short_text_brt_knights_errant	The most junior of Knights, they fight determinedly to make a name for themselves.	true
unit_description_short_texts_text_wh_pro04_unit_short_text_brt_cav_knights_errant_ror	The personification of purity and devotion, striving to become the most honourable Knights of the Realm.	true
unit_description_short_texts_text_wh_dlc08_unit_short_text_grn_mon_giant_boss	All who stand before the Mad Titan are likely trampled underfoot, if not first debilitated by his putrid flatulence!	true
unit_description_short_texts_text_wh2_main_unit_short_text_def_cha_khainite_assassin_0	As swift as the wind, dark as the shadows, deadly as a thousand blades.	true
unit_description_short_texts_text_wh_main_unit_short_text_chs_chaos_marauders	Chaos Marauders are the rank and file of Chaos armies, perfectly placed in the centre of battle, bloodied weapon in hand.	true
unit_description_short_texts_text_wh_dlc06_unit_short_text_grn_krimson_killerz	Armed to da teef and always ready for a scrap, this elite Black Orc regiment wear distinctive red armour.	true
unit_description_short_texts_text_wh_dlc08_unit_short_text_nor_mon_war_mammoth	Once an awe-inspiring parade of powerful beasts, now reduced to the last few dangerous descendants of the legendary herd.	true
unit_description_short_texts_text_wh2_main_unit_short_text_skv_inf_gutter_runners_1	Armed with poison, so even a glancing blow may mean agonising death to the target.	true
unit_description_short_texts_text_wh2_main_unit_short_text_skv_inf_gutter_runners_0	Lightly armoured and nimble beyond the ken of most, Clan Eshin's death squads move fast and kill quickly.	true
unit_description_short_texts_text_wh_pro04_unit_short_text_wef_inf_wildwood_rangers_ror	Centuries of defending the forest against the malevolent spirits of the Wildwood has gifted them an unparalleled vigilance.	true
unit_description_short_texts_text_wh_dlc07_unit_short_text_brt_alberic	As stern and determined as the endless ocean, and as savage as the rolling tempest.	true
unit_description_short_texts_text_wh_dlc05_unit_short_text_bst_harpies	Victims find out too late that the enchanting creature gliding towards them is not a woman, but a savage, rabid beast!	true
unit_description_short_texts_text_wh_main_unit_short_text_vmp_grave_guards	Stalwart defenders of the crypts, Grave Guards possess a fighting skill beyond that of the usual wights.	true
unit_description_short_texts_text_wh2_main_unit_short_text_hef_mon_phoenix_flamespyre	Pure airborne majesty, it brings fire and death as it swoops down over enemy lines.	true
unit_description_short_texts_text_wh_main_unit_short_text_emp_light_wizard	Light Wizards illuminate their foes with magic drawn from the Lore of Light, blazing and binding enemies with purifying brightness.	true
unit_description_short_texts_text_wh_dlc07_unit_short_text_brt_battle_pilgrims	Although a fierce foe to Bretonnia's enemies, Knights should be wary of their kleptomaniac tendencies…	true
unit_description_short_texts_text_wh_dlc03_unit_short_text_bst_minotaur	A ferocious hunger drives axe-wielding Minotaurs into the melee - hunger for war and hunger for flesh.	true
unit_description_short_texts_text_wh_pro04_unit_short_text_brt_cav_questing_knights_ror	Countless forays into the ever-dangerous realm of the fey bordering their homeland has honed these Knights’ skills.	true
unit_description_short_texts_text_wh2_main_unit_short_text_hef_cav_ellyrian_reavers_1	These archers take aim at the enemies of the Elven kingdom, harassing with arrows whilst screening their allies.	true
unit_description_short_texts_text_wh2_main_unit_short_text_hef_cav_ellyrian_reavers_0	Favoured by Caledor, these raiders bring oblivion to Ulthuan's enemies, by spear-tipped charge.	true
unit_description_short_texts_text_wh2_main_unit_short_text_def_cha_sorceress_shadows	Most Sorceresses of Ghrond lurk in the utter darkness, but there are those who walk close to the light still, using illusions to spin cruel visions and tricks to get the souls they desire.	true
unit_description_short_texts_text_wh2_dlc09_tmb_veh_khemrian_warsphinx	A monolithic force of destruction on the battlefield - each tremendous footstep crushing many foolish warriors underfoot.	true
unit_description_short_texts_text_wh_main_unit_short_text_grn_savage_orc_boar_boyz	A Savage Orc, atop his boar, delivers a powerful charge then remains a mighty, fearful presence at the heart of the battle.	true
unit_description_short_texts_text_wh_dlc03_unit_short_text_bst_gor_herd_dual_weapons	With a weapon in each hand, these Gors lunge and slash at anything before them with predictably wild abandon.	true
unit_description_short_texts_text_wh_pro04_unit_short_text_brt_inf_battle_pilgrims_ror	Former grave wardens of the abbey who fight alongside Grail Knights, yearning to accrue relics and slivers of their glory.	true
unit_description_short_texts_text_wh_dlc03_unit_short_text_bst_ungor_spearmen_shields	With shields in hand, these Ungors can engage the enemy and hold their own thereafter.	true
unit_description_short_texts_text_wh_pro04_unit_short_text_bst_inf_gor_herd_ror	The monotonal drones of their crude pipes announce the arrival of the most savage, rowdy, undisciplined, and deadly.	true
unit_description_short_texts_text_wh2_dlc10_unit_short_text_hef_cha_handmaiden	At all times these beautiful warriors accompany the Everqueen, as her advisors and protectors.	true
unit_description_short_texts_text_wh2_main_unit_short_text_def_mon_war_hydra_0	A furious battlefield force; savage in combat and notoriously difficult to kill.	true
unit_description_short_texts_text_wh_dlc07_unit_short_text_brt_questing_knights	He who undertakes the quest must never flinch and never waver, until at last he finds the sacred Grail, and sups.	true
unit_description_short_texts_text_wh2_main_unit_short_text_lzd_inf_saurus_spearmen_blessed_1	Fearsome Saurus marked for greatness by the Old Ones.   	true
unit_description_short_texts_text_wh2_main_unit_short_text_skv_cha_grey_seer_plague_1	The air erupts with contagion and ruin, choking the enemy's lungs and savaging their bodies. 	true
unit_description_short_texts_text_wh2_main_unit_short_text_skv_cha_grey_seer_plague_0	The air erupts with contagion and ruin, choking the enemy's lungs and savaging their bodies. 	true
unit_description_short_texts_text_wh_main_unit_short_text_grn_goblin_great_shaman_0	A Great Shaman summons the power of Gork and Mork, ravaging any in his way.	true
unit_description_short_texts_text_wh2_dlc10_unit_short_text_def_mon_chill_of_sontar_0	The Chill of Sontar is a ruthless killing machine.	true
unit_description_short_texts_text_wh2_main_unit_short_text_lzd_cha_kroq_gar_2	Kroq-Gar is the last survivor of ruined Xhotl, from a spawning that was always marked for greatness.	true
unit_description_short_texts_text_wh2_main_unit_short_text_lzd_cha_kroq_gar_3	Kroq-Gar is the last survivor of ruined Xhotl, from a spawning that was always marked for greatness.	true
unit_description_short_texts_text_wh2_main_unit_short_text_lzd_cha_kroq_gar_0	Kroq-Gar is the last survivor of ruined Xhotl, from a spawning that was always marked for greatness.	true
unit_description_short_texts_text_wh2_main_unit_short_text_lzd_cha_kroq_gar_1	Kroq-Gar is the last survivor of ruined Xhotl, from a spawning that was always marked for greatness.	true
unit_description_short_texts_text_wh_pro04_unit_short_text_brt_cav_mounted_yeomen_ror	The elite of Montfort’s low-born, saddled castle defenders often sent out to harass besiegers with their noxious arrows.	true
unit_description_short_texts_text_wh2_main_unit_short_text_def_cha_dreadlord_2	Power, achieved through intimidation and strength on the battlefield; fear instils loyalty.	true
unit_description_short_texts_text_wh2_main_unit_short_text_def_cha_dreadlord_0	Power, achieved through intimidation and strength on the battlefield; fear instils loyalty.	true
unit_description_short_texts_text_wh2_main_unit_short_text_def_cha_dreadlord_1	Power, achieved through intimidation and strength on the battlefield; fear instils loyalty.	true
unit_description_short_texts_text_wh2_main_unit_short_text_def_cha_dreadlord_4	Power, achieved through intimidation and strength on the battlefield; fear instils loyalty.	true
unit_description_short_texts_text_wh2_main_unit_short_text_def_cha_dreadlord_5	Power, achieved through intimidation and strength on the battlefield; fear instils loyalty.	true
unit_description_short_texts_text_wh2_dlc11_unit_short_text_cst_mon_terrorgheist	A piercing scream, a swooping shadow upon the water – a dead body drained of blood.	true
unit_description_short_texts_text_wh_dlc05_unit_short_text_wef_wild_riders_0	Galloping to war with Orion, his personal guard bring a calamity to all who stand against them.	true
unit_description_short_texts_text_wh2_main_unit_short_text_hef_cha_mage_high	The dwellers of the White Tower use High Magic to destroy enemies and augment allies.	true
unit_description_short_texts_text_wh_main_unit_short_text_dwf_ironbreakers	Trained to fight in tight formations, Ironbreakers form a living line of defence, letting enemies crash over them.	true
unit_description_short_texts_text_wh2_dlc11_unit_short_text_cst_mon_scurvy_dogs	These rabid beasts are the ideal raiding companions, more vicious in death than they ever were in life.	true
unit_description_short_texts_text_wh_dlc07_unit_short_text_brt_grail_reliquae	The interred remains of Knights are defended violently by those whose existence gives them purpose.	true
unit_description_short_texts_text_wh_dlc03_unit_short_text_bst_minotaur_shields	The victims of a Minotaur are ripped limb from limb and then, unfortunately, devoured.	true
unit_description_short_texts_text_wh2_dlc12_unit_short_text_lzd_cav_cold_one_spearriders_ror_0	The Cold Ones upon which they ride instinctively recognise the same cold-blooded cunning within the hearts of these consummate warriors.	true
unit_description_short_texts_text_wh_dlc06_unit_short_text_grn_skarsnik	Pernicious and sly, Skarsnik retains command through deception, subterfuge and no small amount of murder.	true
unit_description_short_texts_text_wh2_main_unit_short_text_lzd_mon_kroxigors_blessed	Strong Kroxigors marked for greatness by the Old Ones. 	true
unit_description_short_texts_text_wh_dlc06_unit_short_text_dwf_ulthars_raiders	Keen and sharp, these Dwarfs know every nook, every cranny of the mountains.	true
unit_description_short_texts_text_wh_dlc03_unit_short_text_bst_ungor_spearmen	Ungors are more nimble than their brethren, useful for flanking foes and harassing with spears.	true
unit_description_short_texts_text_wh2_main_unit_short_text_hef_cha_mage_life	Ghyran - the Lore of Life - is used on the battlefield to heal their allies and frustrate the enemy's designs.	true
unit_description_short_texts_text_wh2_main_unit_short_text_lzd_cha_slann_mage_priest_high_0	These Slann mystics bring ruin to the foe's armies and devastation to its cities.	true
unit_description_short_texts_text_wh2_dlc10_unit_short_text_hef_cha_mage_shadows	The Mages of Saphery excel at all forms of magic; the spells of shadows and illusion are no exception.	true
unit_description_short_texts_text_wh_main_unit_short_text_brt_field_trebuchet	Walls are nothing to the blast of trebuchet fire, and a man's skull fares even worse.	true
unit_description_short_texts_text_wh2_dlc11_unit_short_text_vmp_necrarch_vampire_lord	Grotesque and withered, Necrarchs may be weaker in combat, but their magical prowess is second to none.	true
unit_description_short_texts_text_wh2_main_unit_short_text_lzd_inf_skink_skirmishers_blessed_0	Cunning Skinks marked for greatness by the Old Ones.	true
unit_description_short_texts_text_wh_pro04_unit_short_text_bst_inf_bestigor_herd_ror	More brutish than other Bestigor herds, the Manrippers can resist the charge of the most colossal opponents.	true
unit_description_short_texts_text_wh_dlc04_unit_short_text_emp_volkmar_the_grim	Everything about him is bent to that one great task of holding back evil.	true
unit_description_short_texts_text_wh2_main_unit_short_text_lzd_mon_stegadon_blessed_1	Indomitable Stegadons marked for greatness by the Old Ones.  	true
unit_description_short_texts_text_wh_pro04_unit_short_text_chs_cav_chaos_knights_ror	Loyal followers of the Everchosen, maleficent Knights dedicated with reverent faith to any and all of the Chaos Gods.	true
unit_description_short_texts_text_wh2_dlc11_unit_short_text_cst_art_queen_bess	This Hellhammer Cannon has been refined by the Pirate King himself to be one of the most feared artillery pieces in existence.	true
unit_description_short_texts_text_wh_main_unit_short_text_emp_great_cannon	The Empire's standard, effective cannonry sends armour-piercing iron balls ploughing through enemy ranks with devastating aplomb.	true
unit_description_short_texts_text_wh_dlc07_unit_short_text_brt_royal_hippogryph_knights	A hippogryph is no easy prize, but its power in battle makes the effort to tame one worth it.	true
unit_description_short_texts_text_wh2_dlc10_unit_short_text_hef_inf_everqueens_court_guards_0	Only the purest of heart may serve the Everqueen.	true
unit_description_short_texts_text_wh_dlc06_unit_short_text_dwf_rangers_bugmans	Ever seeking vengeance, these hardy Rangers follow their Brewmaster, delivering grim tidings of upcoming struggles and bolstering the Dwarfs’ defensive lines.	true
unit_description_short_texts_text_wh2_dlc11_unit_short_text_vmp_sylvanian_crossbowmen	Such weapons require little more skill than the ability to point and shoot - even the smallfolk can be trusted with their use.	true
unit_description_short_texts_text_wh2_dlc10_unit_short_text_hef_cav_the_heralds_of_the_wind_0	The Heralds are renowned for their ability to read the ebb and flow of battle.	true
unit_description_short_texts_text_wh_dlc03_unit_short_text_amber_wizard	The Amber Wizard commands the Lore of Beasts, ranging the forces of nature itself against the enemy.	true
unit_description_short_texts_text_wh2_main_unit_short_text_hef_mon_great_eagle	Firm allies for millennia, these majestic birds aid the Elves by swooping onto enemy lines and clawing them apart.	true
unit_description_short_texts_text_wh2_dlc11_unit_short_text_cst_inf_zombie_gunnery_mob_bombers	Undead minions have no fear of blowing themselves up, making them ideal gunpowder-keg-launchers!	true
unit_description_short_texts_text_wh_pro04_unit_short_text_wef_mon_treekin_ror	Within these living, walking timbers, the souls of great Elven warriors wield powers of incendiary magic.	true
unit_description_short_texts_text_wh_dlc05_unit_short_text_wef_treekin	The strongest of souls gather the forest around them and are reborn as instruments of its defence.	true
unit_description_short_texts_text_wh2_dlc09_tmb_cha_tomb_king	The Tomb Kings know nothing but rage and the desire to reclaim their lost kingdoms.	true
unit_description_short_texts_text_wh_dlc08_unit_short_text_nor_shaman_sorcerer	Using his seer-craft, the Shaman-Sorcerer wrangles the Winds to guide the tribe towards war.	true
unit_description_short_texts_text_wh_dlc04_unit_short_text_vmp_direpack	Hurling itself into the fray, the pack's teeth close around limbs and do not let go.	true
unit_description_short_texts_text_wh_dlc03_unit_short_text_bst_razorgor_chariot	Though temperamental, a successful Razorgor Chariot charge causes horrendous damage to the enemy line.	true
unit_description_short_texts_text_wh2_dlc10_unit_short_text_def_mon_feral_manticore_0	These incarnations of Khaine strike fear in to all those who stand before them.	true
unit_description_short_texts_text_wh_dlc01_unit_short_text_chs_forsaken	Little humanity remains within the Forsaken, only a desire for battle, followed by a furious charge into the fray.	true
unit_description_short_texts_text_wh2_dlc12_unit_short_text_skv_veh_doom_flayer_tech_lab_ror_0	Pity the unfortunate facing such a device - they will need every ounce of wit and fighting ability to prevail against it.	true
unit_description_short_texts_text_wh2_dlc11_unit_short_text_cst_mon_rotting_leviathan	A gargantuan, annihilative force of nature, unnaturally brought back from death to wreak yet more death.	true
unit_description_short_texts_text_wh_main_unit_short_text_chs_exalted_hero	Desire for the Gods' attention demands these men fight in the melee with strength far beyond that of mere mortals.	true
unit_description_short_texts_text_wh_dlc06_unit_short_text_grn_durkits_squigs	Riding a Squig is a dangerous, foolish business. Goblins, however, are better riders than most, so live slightly longer.	true
unit_description_short_texts_text_wh_dlc06_unit_short_text_grn_hammer_of_gork	These crude machines hurl rocks with such fury, their targets feel as if Gork himself was assaulting them.	true
unit_description_short_texts_text_wh_dlc05_unit_short_text_vmp_red_duke	“’Good’? I spit on ‘good’! I desire only power, and you watch, for I shall have it!”	true
unit_description_short_texts_text_wh_dlc04_unit_short_text_vmp_corpse_cart_lodestone	When the lodestone bell rings, dark magic exudes and ripples across the battlefield.	true
unit_description_short_texts_text_wh_dlc07_unit_short_text_brt_fay_enchantress	The power that she wields, both on and off the battlefield, shapes the course of nations.	true
unit_description_short_texts_text_wh2_dlc10_unit_short_text_def_cha_supreme_sorceress_shadows	Supreme Sorceresses wield powerful magic that lesser mortals can only dream of.	true
unit_description_short_texts_text_wh2_main_unit_short_text_hef_cav_ithilmar_chariot	Chariots are best employed to deliver destructive charges to the enemy lines - over and over again.	true
unit_description_short_texts_text_wh_pro04_unit_short_text_nor_mon_fimir_ror	Beware the dark, brutish shadows that dwell in the foggy depths of the marsh!	true
unit_description_short_texts_text_wh_dlc01_unit_short_text_chs_kholek_suneater	Kholek Suneater is beyond all mortal reckoning. His fury and strength, like his age, are immense. Truly, he is unstoppable.	true
unit_description_short_texts_text_wh2_dlc09_tmb_mon_ushabti_ror	Bearing the faces of Nehekhara’s illustrious pantheon, these Ushabti use spear-sized arrows – and the fear of the gods – to strike at the unfortunate foe.	true
unit_description_short_texts_text_wh2_dlc09_tmb_mon_ushabti_bow	Tremble at their imposing sight, run in vain from their mighty arrows.	true
unit_description_short_texts_text_wh_main_unit_short_text_dwf_quarrellers_great_axe	Though these Dwarfs excel at a distance, it would be foolhardy to underestimate them in melee.	true
unit_description_short_texts_text_wh2_main_unit_short_text_hef_mon_sun_dragon	Young and impetuous, these Dragons dive down onto enemy ranks with exuberant fury, crushing foes like flies.	true
unit_description_short_texts_text_wh2_main_unit_short_text_skv_inf_gutter_runner_slingers_0	Raining slingshots down then vanishing again, too quickly to be caught; a frustrating nuisance to the foe.	true
unit_description_short_texts_text_wh2_main_unit_short_text_skv_inf_gutter_runner_slingers_1	Raining slingshots down then vanishing again, too quickly to be caught; a frustrating nuisance to the foe.	true
unit_description_short_texts_text_wh_main_unit_short_text_brt_louen_leoncoeur	Fell deeds and dark ruin await those who dare to face the son of Gilles le Breton!	true
unit_description_short_texts_text_wh_dlc04_unit_short_text_vmp_vereks_reavers	From atop skeletal mounts, death and destruction are dealt without contrition.	true
unit_description_short_texts_text_wh2_main_unit_short_text_skv_inf_warpfire_thrower	Warpstone fire belches forth, reducing targets to nothing more than bubbling, crusted blobs.	true
unit_description_short_texts_text_wh2_dlc11_unit_short_text_cst_inf_zombie_gunnery_mob	The random discharge of noisy, indiscriminate firepower gives the Gunnery Mob a small spark of satisfaction enjoyed in life.	true
unit_description_short_texts_text_wh2_dlc09_tmb_cha_necrotect	All the Necrotects see now is purity besmirched. With a whipcrack they strive once more for perfection.	true
unit_description_short_texts_text_wh_main_unit_short_text_brt_lord	The bravest of the brave, the noble Lords of Bretonnia will fight for the Lady until the bitter, bloody end.	true
unit_description_short_texts_text_wh_dlc08_unit_short_text_nor_throgg	The Troll King seeks to grind the realms of civilisation under his monstrous rule.	true
unit_description_short_texts_text_wh_main_unit_short_text_grn_night_goblin_archers	Raining arrows from a distance is the preferred Greenskin tactic.	true
unit_description_short_texts_text_wh2_main_unit_short_text_def_inf_har_ganeth_executioners_0	In the name of Khaine and with draichs in their hands, furious brutality is brought to the battlefield.	true
unit_description_short_texts_text_wh_dlc08_unit_short_text_nor_norscan_giant	He follows those who wage war for the Dark Gods – their killing fields are his feeding grounds.	true
unit_description_short_texts_text_wh_dlc08_unit_short_text_nor_fimir_warriors	Cyclopean fiends, degenerate and malign, ever-vying for the attention of the Dark Gods.	true
unit_description_short_texts_text_wh_dlc08_unit_short_text_vmp_mon_terrorgheist_boss	A terrifying beast of myth and legend, emanating shrieks of the damned from the Ruinous Realm itself.	true
unit_description_short_texts_text_wh_dlc05_unit_short_text_wef_durthu	Even the wisest, most ancient of gentle spirits can be bent to violence by savage, unrelenting war.	true
unit_description_short_texts_text_wh_dlc06_unit_short_text_dwf_rangers	No cave is too dark, no pathway too treacherous for the Ranger to scout and scour and know.	true
unit_description_short_texts_text_wh_dlc01_unit_short_text_chs_chaos_sorcerer_shadows	This Chaos Sorcerer employs dark and nefarious magics to tear through both body and mind.	true
unit_description_short_texts_text_wh_dlc04_unit_short_text_emp_sunmaker	Its destructive power cannot be overstated, the world illuminated by a turbulent battery of missile fire.	true
unit_description_short_texts_text_wh2_dlc11_unit_short_text_cst_inf_depth_guard_polearms	The only thing scarier than a Depth Guard is one with a weapon that gives it an eight-foot reach.	true
unit_description_short_texts_text_wh_main_unit_short_text_brt_knights_of_the_realm	The Knights ride down their enemies with a thunderous charge and a cry of valour.	true
unit_description_short_texts_text_wh2_dlc09_tmb_cav_skeleton_horsemen	Amidst a churning cloud of heaved-up sand, these Undead warriors charge their foes with supernatural determination.	true
unit_description_short_texts_text_wh_dlc06_unit_short_text_dwf_old_grumblers	All Dwarfs complain, all Longbeards moan, but none gripe and fight half as much as these courageous old gits.	true
unit_description_short_texts_text_wh_dlc08_unit_short_text_nor_art_hellcannon_battery	Feeding on a banquet of flesh tossed into their dire-furnaces, these Hellcannons fire bolts of devastating energy towards distant enemies.	true
unit_description_short_texts_text_wh2_pro07_unit_short_text_emp_amethyst_wizard	Wielding powers seemingly tantamount to Necromancy, these dark Wizards can leech and hex the souls of their enemies.	true
unit_description_short_texts_text_wh2_dlc09_tmb_cav_skeleton_horsemen_archers	These riders never tire and can chase foes down over countless leagues, until their dying moment.	true
unit_description_short_texts_text_wh_main_unit_short_text_emp_great_swords	Wielding double-handed swords and wearing heavy plate, Greatswords are a potent elite unit with an impressive melee strength.	true
unit_description_short_texts_text_wh_main_unit_short_text_vmp_crypt_ghouls	Crypt Ghouls are barely sentient but they can fight, using their claws and makeshift weapons to rip men apart.	true
unit_description_short_texts_text_wh_dlc06_unit_short_text_dwf_runelord	The greatest of Runesmiths rides into battle atop the Anvil of Doom, smiting all foes with magical fury.	true
unit_description_short_texts_text_wh2_dlc10_unit_short_text_hef_inf_shadow_warriors_0	The Shadow Warriors of Nagarythe are grim soldiers who fight for revenge alone.	true
unit_description_short_texts_text_wh_dlc03_unit_short_text_bst_bray_shaman_wild	The earth speaks and the Bray-Shaman hears it. Nature flows through him, giving him mastery over the land itself.	true
unit_description_short_texts_text_wh_dlc06_unit_short_text_grn_wurrzag	Wurrzag is beholden to no tribe nor lord, only the whisperings of the Greenskin gods in his addled mind.	true
unit_description_short_texts_text_wh_pro04_unit_short_text_bst_inf_cygor_ror	The glow of the rock exacerbates its curse, tormenting it with even more vivid visions than other Cygors.	true
unit_description_short_texts_text_wh_pro04_unit_short_text_chs_inf_chaos_warriors_ror	An ancient lineage of warriors supremely enhanced by the energies of Chaos, nourished only by carnage and bloodshed.	true
unit_description_short_texts_text_wh2_main_unit_short_text_hef_mon_phoenix_frostheart	The touch of an aged Phoenix is enough to freeze a warrior to death.	true
unit_description_short_texts_text_wh2_main_unit_short_text_lzd_inf_saurus_warriors_blessed_1	Mighty Saurus marked for greatness by the Old Ones. 	true
unit_description_short_texts_text_wh_pro04_unit_short_text_chs_inf_forsaken_ror	The zealousness of the Forsaken is especially great in those reborn in the macabre paradise of the Garden of Nurgle.	true
unit_description_short_texts_text_wh_dlc05_unit_short_text_bst_morghur	Morghur does not care for the world as it is, preferring to remake it according to his ever-changing whims.	true
unit_description_short_texts_text_wh2_dlc09_tmb_mon_carrion_ror	The keen eyes of Djaf’s Carrion can spot a meal - or an artillery target - over great distances.	true
unit_description_short_texts_text_wh2_main_unit_short_text_lzd_mon_ancient_stegadon	This ancient, revered beast is a fearsome sight on the battlefield - their giant blowpipes causing much destruction.	true
unit_description_short_texts_text_wh2_dlc10_unit_short_text_hef_inf_sisters_of_avelorn_0	Guardians of the sacred places of Avelorn, these peerless archers are incorruptible.	true
unit_description_short_texts_text_wh_dlc05_unit_short_text_wef_glade_guard_2	The definitive Wood Elf warriors within the armies of Athel Loren, bolstered by magical, poisoned arrow-tips for additional advantage.	true
unit_description_short_texts_text_wh_dlc05_unit_short_text_wef_glade_guard_0	In many ways, these warriors define the armies of Athel Loren - their bows and blades are at the forefront of any action.	true
unit_description_short_texts_text_wh_dlc05_unit_short_text_wef_glade_guard_1	Stalwarts of Athel Loren’s Elven armies, these bow and blade-armed warriors’ arrows burn with an enchanted flame to ignite flammable targets.	true
unit_description_short_texts_text_wh_dlc05_unit_short_text_wef_dryads	There is no bargaining when the forest is damaged; vengeance will be exacted.	true
unit_description_short_texts_text_wh2_dlc11_unit_short_text_cst_mon_rotting_prometheans_gunnery_mob_ror	Detestable Undead dragoons of the sea, risen to expedite vengeance in the form of giant pincers and rusty bullets.	true
unit_description_short_texts_text_wh_dlc06_unit_short_text_grn_nasty_skulkers	Even the most heinous green-skinned scumbags look upon these Goblins' swift skulduggery with reverent horror.	true
unit_description_short_texts_text_wh2_dlc12_unit_short_text_lzd_cha_skink_chief_red_crested_0	Marked for greatness amidst an already-blessed spawning, these Skink Chiefs are the leaders of their red-crested legions.	true
unit_description_short_texts_text_wh2_dlc12_unit_short_text_lzd_mon_salamander_pack_0	Almost too much lizard for their Skink handlers to handle, there's almost no holding these natural predators back!	true
unit_description_short_texts_text_wh_dlc05_unit_short_text_wef_wildwood_rangers	Agile and deadly in melee - an excellent first-response to impending threats.	true
unit_description_short_texts_text_wh_main_unit_short_text_emp_state_swordsmen	The Swordsmen form a resolute battle line. Blades in hand, they thrive in melee, at the heart of battle.	true
unit_description_short_texts_text_wh2_main_unit_short_text_def_cav_cold_one_chariot	A charge so devastating that it rends the flesh and bone from its victims.	true
unit_description_short_texts_text_wh2_dlc09_tmb_inf_tomb_guard	These guards' loyalty in life was rewarded; now they are expected to show it once more.	true
unit_description_short_texts_text_wh_main_unit_short_text_grn_goblin_wolf_riders_0	A pack of Wolf Riders can appear from nowhere, strike with precision, and be away before the enemy knows what has happened.	true
unit_description_short_texts_text_wh2_main_unit_short_text_lzd_inf_chameleon_skinks_blessed_0	Proficient hunters marked for greatness by the Old Ones. 	true
unit_description_short_texts_text_wh_main_unit_short_text_grn_forest_goblin_spider_rider_0	Atop their venomous mounts, Goblin Riders can run down enemies with surprising precision.	true
unit_description_short_texts_text_wh_main_unit_short_text_chs_chaos_warhounds	A well-placed kennel of Warhounds, set loose on the enemy lines, can thread injury and debilitating poison amongst the enemy.	true
unit_description_short_texts_text_wh_dlc04_unit_short_text_emp_silver_bullets	With a thunderous roll, a volley of devastating, armour-piercing fire is loosed.	true
unit_description_short_texts_text_wh_dlc03_unit_short_text_bst_khazrak_one_eye	More than a savage and destructive beast, Khazrak has a keen mind for strategy combined with animal cunning and guile.	true
unit_description_short_texts_text_wh2_dlc10_unit_short_text_hef_inf_scions_of_mathlann_0	Defenders of Cothique and chosen by the Lord of the Deeps himself.	true
unit_description_short_texts_text_wh2_main_unit_short_text_hef_inf_lothern_sea_guard_1	Unlike other levied citizen militias, the Lothern Sea Guard remain armed and ready at all times.	true
unit_description_short_texts_text_wh2_main_unit_short_text_hef_inf_lothern_sea_guard_0	Unlike other levied citizen militias, the Lothern Sea Guard remain armed and ready at all times.	true
unit_description_short_texts_text_wh_main_unit_short_text_grn_orc_boar_boyz	Prideful - and all the more deadly for it - the Boar Boyz deal grizzly death from atop their mounts.	true
unit_description_short_texts_text_wh2_dlc11_unit_short_text_vmp_sylvanian_handgunners	Fortunately, the smallfolk can be fielded in such numbers that the handgun's lack of accuracy and tendency to explode does little to blunt their attack.	true
unit_description_short_texts_text_wh_dlc01_unit_short_text_chs_sigvald_the_magnificent	Unblemished, frozen in time, pristine - the skin-deep appearance of Sigvald belies a twisted, corrupted, vicious soul, hungry for destruction.	true
unit_description_short_texts_text_wh_main_unit_short_text_emp_witch_hunter	With pistol in hand and a furious desire to root out heresy, the Witch Hunter is a formidable fighter.	true
unit_description_short_texts_text_wh2_main_unit_short_text_lzd_mon_carnosaur_0	First come the vibrations; next the distant sound of destruction; finally, carnage is unleashed. Good luck.	true
unit_description_short_texts_text_wh_dlc03_unit_short_text_bst_gor_herd	Gors may be rank-and-file beasts, but that does not diminish their ferocity on the battlefield.	true
unit_description_short_texts_text_wh2_dlc11_unit_short_text_cst_mon_rotting_prometheans	Scuttling across the battlefield, these killer arthropods want nothing less than to dismember and decapitate anything that comes near.	true
unit_description_short_texts_text_wh2_main_unit_short_text_lzd_cha_slann_mage_priest_heavens_0	These Slann mystics bring ruin to the foe's armies and devastation to its cities.	true
unit_description_short_texts_text_wh_main_unit_short_text_vmp_vampire_lord	The Vampire Lord takes to melee with power and growing madness, both on foot and atop monstrous, powerful mounts.	true
unit_description_short_texts_text_wh_main_unit_short_text_chs_chaos_trolls	Though temperamental and difficult to control, a Troll is a whirling ball of difficult-to-kill death.	true
unit_description_short_texts_text_wh_main_unit_short_text_grn_night_goblin_shaman_0	Maddened by dank mould and mushrooms, a Goblin Shaman hurls debilitating spells into the enemy's ranks with chaotic abandon.	true
unit_description_short_texts_text_wh2_dlc12_unit_short_text_lzd_inf_temple_guards_ror_0	Only the strongest spawnings, in both mind and body, are fit to guard the Old Ones' Star Chambers.	true
unit_description_short_texts_text_wh_dlc06_unit_short_text_dwf_skolder_guard_irondrakes	The Dwarfs of Clan Norgrimling are determined to see their enemies wiped out with a whoosh of scalding, cleansing steam.	true
unit_description_short_texts_text_wh_dlc03_unit_short_text_bst_giants	Giants attack the enemy in a rage, with flailing limbs that break both man and machine apart.	true
unit_description_short_texts_text_wh_dlc03_unit_short_text_bst_chaos_warhounds_poison	This beast's bite brings not just pain, but also a cruel toxicity that courses through every vein.	true
unit_description_short_texts_text_wh_main_unit_short_text_dwf_flame_cannon	Flame Cannons belch burning pitch across the battlefield, raining molten death upon the enemy.	true
unit_description_short_texts_text_wh2_dlc10_unit_short_text_hef_cha_mage_heavens	High Elves have been studying the night skies long before the astromancers of the Empire, and so can freely manipulate the Wind of Azyr.	true
unit_description_short_texts_text_wh_dlc03_unit_short_text_bst_minotaur_great_weapons	A Minotaur, with axe in hand, can hold its own against dozens of enemies with vicious, brutal fury.	true
unit_description_short_texts_text_wh_main_unit_short_text_grn_night_goblins	Night Goblins raid with efficiency; they swarm and ambush, cutting their foes apart.	true
unit_description_short_texts_text_wh_main_unit_short_text_dwf_miners_charges	The pickaxe is not the mightiest Dwarfen weapon, but explosives even things out somewhat.	true
unit_description_short_texts_text_wh2_dlc11_unit_short_text_cst_mon_necrofex_colossus	A colossal walking frame of galleon-torn timber, iron, and man-flesh, relentlessly driven by a vortex of deathly energy.	true
unit_description_short_texts_text_wh2_main_unit_short_text_lzd_inf_skink_skirmishers_0	More reliable than others of their class, a blowpipe-primed unit can fell scores of unsuspecting enemies.	true
unit_description_short_texts_text_wh2_main_unit_short_text_lzd_mon_stegadon_0	These mighty savages are armed and armoured by design; woe betide any being who encroaches on their territory!	true
unit_description_short_texts_text_wh2_main_unit_short_text_lzd_mon_stegadon_1	From atop enormous and reverent Stegadons, their crew fire enormous bolts from giant crossbows, decimating enemy ranks.	true
unit_description_short_texts_text_wh_dlc05_unit_short_text_wef_glade_riders_0	Agile and swift beyond measure, these mounted warriors' missiles spell doom for their opponents.	true
unit_description_short_texts_text_wh_dlc05_unit_short_text_wef_glade_riders_1	Swift and deadly, these mounted archers use arrows dipped in poison and charged with magic to weaken and slow their targets.	true
unit_description_short_texts_text_wh2_dlc09_tmb_mon_heirotitan	Death's true face radiates sinister magic; the cruel laughter of ancient gods echoes within its shadow.	true
unit_description_short_texts_text_wh_main_unit_short_text_vmp_cairn_wraiths	Extremely effective in battle, the Cairn Wraith has no corporeal form, making it extremely difficult to kill with conventional weaponry.	true
unit_description_short_texts_text_wh_main_unit_short_text_chs_chaos_chariot	A Chaos Chariot is a terrifying thing to slam into an enemy line, punching through with maddening strength. 	true
unit_description_short_texts_text_wh_main_unit_short_text_dwf_slayers	Slayers are elite units with a thirst for death, fighting hard in melee until the enemy dies, or they do.	true
unit_description_short_texts_text_wh_dlc08_unit_short_text_nor_feral_mammoth	Trained to trample on command, a Mammoth can easily reduce enemies to a bloody ground-smear.	true
unit_description_short_texts_text_wh_dlc03_unit_short_text_bst_bestigor_herd	The strongest, meanest Beastmen, Bestigors seek out elite foes to slaughter and dominate.	true
unit_description_short_texts_text_wh_main_unit_short_text_brt_peasant_bowmen	Although inaccurate, Peasant Bowmen provide a cheap, plentiful line of defence against the oncoming enemy.	true
unit_description_short_texts_text_wh_dlc08_unit_short_text_chs_mon_dragon_ogre_shaggoth_boss	This millennia-old Shaggoth has little on its mind other than destroying entire tribes of men with its deadly lightning storms.	true
unit_description_short_texts_text_wh2_dlc10_unit_short_text_def_inf_the_bolt_fiends_0	A bolt in the eye is a terrible way to die, and the calling card of the Bolt-fiends.	true
unit_description_short_texts_text_wh_main_unit_short_text_dwf_longbeards_0	Longbeards are veteran fighters of many wars, most resolute in their shieldwall and grumpiest in spirit.	true
unit_description_short_texts_text_wh_main_unit_short_text_dwf_longbeards_1	Longbeards are veteran fighters of many wars, rending armour with the two-handed az and cleaving opponents in two.	true
unit_description_short_texts_text_wh_dlc08_unit_short_text_nor_fimir_balefiend	Balefiends revel in the instability they create between worlds, urging the Dark Gods to favour the Fimir once again.	true
unit_description_short_texts_text_wh_dlc02_unit_short_text_vmp_blood_knights	The Flag of the Blood Keep flashes violently; the Blood Knights run their enemies down.	true
unit_description_short_texts_text_wh_pro03_unit_short_text_vmp_krell	Lord of Undeath, this mighty Champion of Chaos defies mortality once more to defeat his enemies across time.	true
unit_description_short_texts_text_wh_dlc06_unit_short_text_chs_marauder_horsemasters	Horse-born leaders, their powerful steeds a symbol of dread status before the Dark Gods.	true
unit_description_short_texts_text_wh_main_unit_short_text_vmp_crypt_horrors	Monstrous, mutated and savage, a Crypt Horror is devastating against the enemy frontline.	true
unit_description_short_texts_text_wh2_main_unit_short_text_def_art_reaper_bolt_thrower	Their bolts strike with such force that, should their targets survive, they are unfit to live even as slaves.	true
unit_description_short_texts_text_wh2_main_unit_short_text_lzd_inf_saurus_spearmen_0	The charge will fall upon them and be repelled by resolute hands bearing resolute polearms.	true
unit_description_short_texts_text_wh2_main_unit_short_text_lzd_inf_saurus_spearmen_1	Watch as the foe throws itself upon these warriors' spears. Those who survive must then face shield and claw.	true
unit_description_short_texts_text_wh2_dlc12_unit_short_text_lzd_cha_tehenhauin_0	The Prophet seeks to deliver Lustria from its beleaguerment by way of the only tribute acceptable to Sotek – prodigious sacrifice!	true
unit_description_short_texts_text_wh2_pro06_unit_short_text_tmb_mon_bone_giant	The Necrolith Colossi are great bestriding monuments, often in the shape of hulking skeletons.	true
unit_description_short_texts_text_wh_dlc08_unit_short_text_nor_marauders_great	Great weapons increase the chances that the ambitious, yet lowly, Marauder may ensnare the attention of the Gods.	true
unit_description_short_texts_text_wh_main_unit_short_text_chs_chaos_warriors	Chaos Warriors come alive in the midst of bloody battle; thriving on the slaughter of similar foes.	true
unit_description_short_texts_text_wh2_dlc11_unit_short_text_cst_art_carronade	Broadside cannons for sinking mortal ships are devastating when used in the field, pulverising living flesh and solid walls.	true
unit_description_short_texts_text_wh_main_unit_short_text_emp_state_spearmen	Spearmen provide the backbone of the Empire's battle line, a defensive row of spears against the enemy charge.	true
unit_description_short_texts_text_wh_dlc08_unit_short_text_nor_marauders_spear	These Marauders use a wall of spears to impale their enemies, ever in the hope of Ruinous exaltation.	true
unit_description_short_texts_text_wh2_dlc09_tmb_mon_tomb_scorpion_venom	With a swish of their lethal, poisoned tails, the foe is rendered paralysed and helpless, to be consumed by ravening jaws.	true
unit_description_short_texts_text_wh2_main_unit_short_text_hef_cha_tyrion_1	The greatest warrior the High Elves have ever known, eschewing dreams of kingship for glory in battle.	true
unit_description_short_texts_text_wh2_main_unit_short_text_hef_cha_tyrion_0	The greatest warrior the High Elves have ever known, eschewing dreams of kingship for glory in battle.	true
unit_description_short_texts_text_wh2_dlc10_unit_short_text_def_mon_kharibdyss_0	A loathsome beast of uncharted depths possessing colossal strength and insatiable hunger.	true
unit_description_short_texts_text_wh_dlc08_unit_short_text_nor_war_mammoth_warshrine	This vicious beast carries a warshrine aloft, carrying blasphemous icons and unholy relics to battle in sight of the Chaos Gods.	true
unit_description_short_texts_text_wh_main_unit_short_text_emp_captain_empire	A Captain of the Empire is a Hero, a specialist in melee who leads by his courageous example.	true
unit_description_short_texts_text_wh2_dlc12_unit_short_text_lzd_cha_tiktaqto_0	The foremost airborne defender of the temple-cities is peerless in his vigilance and daring, timing aerial assaults to deadly perfection.	true
unit_description_short_texts_text_wh_main_unit_short_text_emp_balthasar_gelt	The way of fire is nothing compared to the fluid power of metal!	true
unit_description_short_texts_text_wh_pro04_unit_short_text_wef_inf_eternal_guard_ror	These noble sons from the High Realms of Athel Loren practice the art of war with obsession.	true
unit_description_short_texts_text_wh2_dlc09_tmb_inf_nehekhara_warriors	The Warriors of Nehekhara remember only their duty to their king, and pursue his enemies with ruthless purpose.	true
unit_description_short_texts_text_wh2_main_unit_short_text_hef_inf_gate_guard	The Emerald Gate - one of the wonders of the Old World - is guarded only by the best of the best.	true
unit_description_short_texts_text_wh_main_unit_short_text_grn_giant	A lumbering Giant is the terror of the battlefield, smashing entire ranks of men aside and feasting on the less fortunate ones.	true
unit_description_short_texts_text_wh_main_unit_short_text_dwf_thane	The Thane leads Dwarfs to battle with a cry of vengeance and an unstoppable rage.	true
unit_description_short_texts_text_wh_main_unit_short_text_grn_grimgor	Backed up by his Black Orc bodyguard "Da Immortulz", Grimgor is "Da Best" - the brutal will of Gork made manifest.	true
unit_description_short_texts_text_wh2_dlc09_unit_short_text_skv_cha_tretch_craventail	Tretch's formidable repertoire of underhanded skills, combined with his famously good luck, has led to a number of legendary deeds!	true
unit_description_short_texts_text_wh2_dlc09_tmb_cav_necropolis_knights_halberd	Tethered to their mounts by a sharp hook, the other mummified hand wields a barbed staff to carve through mortal flesh.	true
unit_description_short_texts_text_wh_main_unit_short_text_grn_azhag	Nobody knows what the crown is or where it is from, but through it Azhag gains clairvoyance and power.	true
unit_description_short_texts_text_wh_dlc04_unit_short_text_vmp_mortis_engine	Bolstering the fighting spirit of all those around it and blasting enemy ranks with savage, dark energy.	true
unit_description_short_texts_text_wh2_dlc11_unit_short_text_cst_inf_zombie_gunnery_mob_rifles	Rifles afford better accuracy, which can be advantageous for the clumsy hands of the rotting Undead.	true
unit_description_short_texts_text_wh_dlc06_unit_short_text_dwf_peak_gate_guard	All Karaks are defended with vigour, but none hold the line with as much determination as these hammer-wielding guards.	true
unit_description_short_texts_text_wh2_main_unit_short_text_skv_inf_plague_monk_censer_bearer	Half-mad, swinging their censers violently and damning all those nearby to a pestilent demise.	true
unit_description_short_texts_text_wh_main_unit_short_text_grn_trolls	Up close, a Troll will batter foes into submission or vomit disgusting and potently corrosive bile across the field.	true
unit_description_short_texts_text_wh_dlc03_unit_short_text_bst_ungor_raiders	Although diminutive by Beastmen standards, Ungors are both faster and more nimble than others of their kind.	true
unit_description_short_texts_text_wh2_dlc11_unit_short_text_cst_cav_deck_droppers_ror	Until their targets lie dead and bullet-riddled, there is no rest for the Salt Lord’s wicked assailants of the skies.	true
unit_description_short_texts_text_wh_dlc06_unit_short_text_grn_mogrubbs_mangy_marauders	Dishevelled and mange-ridden, these wolves (and their riders) are savage beasts all the same.	true
unit_description_short_texts_text_wh2_dlc12_unit_short_text_lzd_cav_ripperdactyl_riders_ror_0	The most experienced riders atop some of the least controllable beasts in existence? Prepare to meet your death!	true
unit_description_short_texts_text_wh_main_unit_short_text_emp_bright_wizard	The Lore of Fire imbues Bright Wizards with the power to call searing fire and burning death upon those who oppose them.	true
unit_description_short_texts_text_wh2_dlc12_unit_short_text_lzd_mon_ancient_stegadon_1	This great beast has both the temperament and strength to bear the Engines of the Gods to battle and beyond.	true
unit_description_short_texts_text_wh_dlc05_unit_short_text_wef_eternal_guard_1	The spear and shield of the Wood Elves, seldom bested in combat.	true
unit_description_short_texts_text_wh_dlc05_unit_short_text_wef_eternal_guard_0	Beneath the fortress of boughs, Athel Loren is defended with blood.	true
unit_description_short_texts_text_wh2_main_unit_short_text_hef_mon_moon_dragon	Matured and wise, they savage enemy battlelines with claws and fearsome flames.	true
unit_description_short_texts_text_wh2_main_unit_short_text_hef_cha_princess_5	High Elf aristocrats are precise and calculating, and they bring this nature to the battlefield.	true
unit_description_short_texts_text_wh2_main_unit_short_text_hef_cha_princess_4	High Elf aristocrats are precise and calculating, and they bring this nature to the battlefield.	true
unit_description_short_texts_text_wh2_main_unit_short_text_hef_cha_princess_3	High Elf aristocrats are precise and calculating, and they bring this nature to the battlefield.	true
unit_description_short_texts_text_wh_main_unit_short_text_emp_helstorm_rocket_battery	An erratic flurry of explosive airborne destruction - Helstorm rockets are extremely powerful, if extremely unreliable, weapons from the Empire's arsenal.	true
unit_description_short_texts_text_wh2_main_unit_short_text_hef_cha_princess_1	High Elf aristocrats are precise and calculating, and they bring this nature to the battlefield.	true
unit_description_short_texts_text_wh2_main_unit_short_text_hef_cha_princess_0	High Elf aristocrats are precise and calculating, and they bring this nature to the battlefield.	true
unit_description_short_texts_text_wh2_dlc09_tmb_cha_master_necromancer	The keeper of the arcane lore casts terrible curses, summoning vengeful desert spirits to feast upon their souls.	true
unit_description_short_texts_text_wh2_dlc11_unit_short_text_cst_mon_mournguls	Terrifyingly ravenous mockeries of life, bound into monstrous groups with arcane spells.	true
unit_description_short_texts_text_wh_main_unit_short_text_grn_savage_orc_arrer_boyz	Savage Orc Arrer Boyz aren't always precise but remain deadly. Precisely deadly, you might say.	true
unit_description_short_texts_text_wh2_dlc10_unit_short_text_hef_cha_alarielle	Alarielle the Radiant, High Priestess of Isha and Everqueen of Ulthuan.	true
unit_description_short_texts_text_wh2_main_unit_short_text_def_cha_death_hag_1	Potions, poisons, and words of power, to affect weak minds or strike their owners down.	true
unit_description_short_texts_text_wh2_main_unit_short_text_def_cha_death_hag_0	Potions, poisons, and words of power, to affect weak minds or strike their owners down.	true
unit_description_short_texts_text_wh_main_unit_short_text_dwf_miners	The pickaxe is not the mightiest Dwarfen weapon, but it serves with relative success in melee.	true
unit_description_short_texts_text_wh2_main_unit_short_text_hef_cha_alastair_5	High Elf aristocrats are precise and calculating, and they bring this nature to the battlefield.	true
unit_description_short_texts_text_wh2_main_unit_short_text_hef_cha_alastair_4	High Elf aristocrats are precise and calculating, and they bring this nature to the battlefield.	true
unit_description_short_texts_text_wh2_main_unit_short_text_hef_cha_alastair_0	High Elf aristocrats are precise and calculating, and they bring this nature to the battlefield.	true
unit_description_short_texts_text_wh2_main_unit_short_text_hef_cha_alastair_3	High Elf aristocrats are precise and calculating, and they bring this nature to the battlefield.	true
unit_description_short_texts_text_wh_main_unit_short_text_chs_chaos_sorcerer_metal	This Chaos Sorcerer can create a whirling storm of blades and destruction to bring ruin to his foes.	true
unit_description_short_texts_text_wh_main_unit_short_text_dwf_ungrim	"This majestic helm has been worn by every Slayer King since the time of King Baragor!"	true
unit_description_short_texts_text_wh_main_unit_short_text_emp_warrior_priest	These men wade into battle with conventional weapons, but can also call powerful magical forces to decimate their enemies.	true
unit_description_short_texts_text_wh2_dlc12_unit_short_text_lzd_lzd_cha_kroak_0	The eldest of the fabled First Generation and the original Relic Priest, Kroak labours tirelessly to further the Great Plan.	true
unit_description_short_texts_text_wh2_dlc10_unit_short_text_hef_inf_the_grey_0	The Elves of the Grey have battled ceaselessly for generations, and will continue that tradition for generations to come.	true
unit_description_short_texts_text_wh2_dlc10_unit_short_text_def_cav_doomfire_warlocks_0	Hollow-eyed murderers, the Doomfire Warlocks must loosen the grip of Slaanesh with the blood of others.	true
unit_description_short_texts_text_wh_main_unit_short_text_dwf_master_engineer	Who dares damage my engines!	true
unit_description_short_texts_text_wh_dlc04_unit_short_text_vmp_helman_ghorst	What is death but an obstacle to be overcome? There is no true death beneath the eternal night.	true
unit_description_short_texts_text_wh2_dlc11_unit_short_text_cst_inf_zombie_deckhands_polearms	The Deckhands’ polearms are rusty extensions of the decomposing arms that brandish them.	true
unit_description_short_texts_text_wh_main_unit_short_text_vmp_zombies	Driven not by skill, but by a desire to feast on flesh, Zombies are good, terrifying fodder in melee.	true
unit_description_short_texts_text_wh2_main_unit_short_text_lzd_cav_terradon_riders_0	These Lizardmen riders swoop down upon the enemy lines to harass them from above.	true
unit_description_short_texts_text_wh2_main_unit_short_text_lzd_cav_terradon_riders_1	These Lizardmen riders swoop down upon the enemy lines to harass them from above.	true
unit_description_short_texts_text_wh_main_unit_short_text_grn_goblin_big_boss	Though powerful enough in battle, a Goblin Boss can also employ all manner of trickery to ensure victory.	true
unit_description_short_texts_text_wh_main_unit_short_text_dwf_gyrocopter_0	The skilled Gyrocopter pilot unleashes jets of steam upon unprepared battle lines.	true
unit_description_short_texts_text_wh_main_unit_short_text_dwf_gyrocopter_1	The Brimstone Gun gives the Gyrocopter pilot a more accurate and lethal tool, ideal for obliterating the target completely!	true
unit_description_short_texts_text_wh_main_unit_short_text_dwf_dwarf_warriors	With az in hand, Dwarfen warriors lay into the front lines with unremitting violence.	true
unit_description_short_texts_text_wh_dlc04_unit_short_text_emp_hammer_of_the_witches	The Hammer of the Witches, fired with righteous purpose, smites evil with thunderous, armour-shattering blasts.	true
unit_description_short_texts_text_wh_main_unit_short_text_vmp_black_knights	Atop their skeletal steeds, Black Knights destroy enemy battle lines with powerful cavalry charges.	true
unit_description_short_texts_text_wh2_dlc10_unit_short_text_def_inf_the_hellebronai_0	Disciplined and merciless, it is a pleasure to watch the Hellebronai work.	true
unit_description_short_texts_text_wh2_main_unit_short_text_hef_mon_star_dragon	The most ancient of Dragons, they destroy the foe with a power that can halt Chaos itself.	true
unit_description_short_texts_text_wh2_main_unit_short_text_def_cav_cold_one_knights_0	Armed with a mighty lance for a powerful charge, then enchanted swords to deliver punishment up close.	true
unit_description_short_texts_text_wh2_main_unit_short_text_def_cav_cold_one_knights_1	Their charge protected by heavy barding, these mounted warriors wield mighty blades to slash and gore.	true
unit_description_short_texts_text_wh_main_unit_short_text_brt_pegasus_knights	Stronger and faster than the mightiest warhorse, the Pegasus Knight swoops across the battlefield with a powerful airborne charge.	true
unit_description_short_texts_text_wh2_dlc12_unit_short_text_lzd_mon_bastiladon_3	This 'Living Bastion' has few predators save the terrain it must traverse, making it the ideal conveyor for the Ark of Sotek itself.	true
unit_description_short_texts_text_wh_main_unit_short_text_brt_mounted_yeomen	From horseback, these Yeomen bring death across the battlefield to where it's needed most.	true
unit_description_short_texts_text_wh2_main_unit_short_text_lzd_mon_carnosaur_blessed_0	Ferocious Carnosaurs marked for greatness by the Old Ones. 	true
unit_description_short_texts_text_wh_main_unit_short_text_emp_general_empire	The Lord commander wades into battle, cutting foes apart and setting an example for the rest of the army.	true
unit_description_short_texts_text_wh_main_unit_short_text_brt_mounted_yeomen_archers	Archery from horseback is fast and dangerous to the enemy, who have little time to react.	true
unit_description_short_texts_text_wh2_main_unit_short_text_def_inf_shades_0	Betrayed and outcast by their peers, they bring savage vengeance to any who cross them.	true
unit_description_short_texts_text_wh2_main_unit_short_text_def_inf_shades_1	The twin blades of these spurned Elves are brought to bear with truly brutal results.	true
unit_description_short_texts_text_wh2_main_unit_short_text_def_inf_shades_2	The strength of these spiteful warriors is borne out by the horrific power of their weapons.	true
unit_description_short_texts_text_wh2_main_unit_short_text_skv_mon_rat_ogres	Patchwork creations of pure brawn and unthinking rage, they charge with the desire only to destroy.	true
unit_description_short_texts_text_wh_dlc07_unit_short_text_brt_grail_guardians	The holy relics of the Lady, the most sacred in all Bretonnia, are guarded by the most fervent and fearsome of warriors.	true
unit_description_short_texts_text_wh_dlc03_unit_short_text_bst_centigors_throwing_axes	Though clumsy, Centigors can still lodge a throwing axe deep into an enemy skull from afar.	true
unit_description_short_texts_text_wh2_main_unit_short_text_lzd_cha_slann_mage_priest_light_0	These Slann mystics bring ruin to the foe's armies and devastation to its cities.	true
unit_description_short_texts_text_wh2_main_unit_short_text_def_cha_malekith_0	Malekith has done much and risked much more to achieve dominion; he will do more still…	true
unit_description_short_texts_text_wh2_main_unit_short_text_def_cha_malekith_1	Malekith has done much and risked much more to achieve dominion; he will do more still…	true
unit_description_short_texts_text_wh2_main_unit_short_text_def_cha_malekith_2	Malekith has done much and risked much more to achieve dominion; he will do more still…	true
unit_description_short_texts_text_wh2_main_unit_short_text_def_cha_malekith_3	Malekith has done much and risked much more to achieve dominion; he will do more still…	true
unit_description_short_texts_text_wh_dlc06_unit_short_text_grn_da_warlordz_boyz	A bunch of sneaky, venal, stabby gits - a suitably befitting bodyguard for the treacherous Warlord of the Eight Peaks.	true
unit_description_short_texts_text_wh_main_unit_short_text_brt_paladin	The bravest of warriors, Paladins charge into battle either mounted or on foot, bringing righteous death in the Lady's name.  	true
unit_description_short_texts_text_wh_dlc07_unit_short_text_brt_damsel_beasts	To control animals and twist their natural aggression to your own ends shows true mastery of your art.	true
unit_description_short_texts_text_wh_main_unit_short_text_chs_chosen	Chosen are greater than their Chaotic brethren, more powerful and savage in close quarters, especially with great weapons.	true
unit_description_short_texts_text_wh2_dlc12_unit_short_text_skv_inf_stormvermin_ror_0	In a society as corrupt and perfidious as this, the law-makers must be protected from those over whom they rule.	true
unit_description_short_texts_text_wh2_dlc10_unit_short_text_hef_inf_the_storm_riders_0	The sight of the Storm Riders' banners strikes fear in to the hearts of even the most merciless Druchii.	true
unit_description_short_texts_text_wh2_main_unit_short_text_lzd_cav_cold_ones_feral_0	Untamed Cold Ones are far too unpredictable to be ridden into battle; simply point them at the foe and stay out of their way!	true
unit_description_short_texts_text_wh2_main_unit_short_text_hef_inf_spearmen_0	All High Elves, both highborn and low, must defend Ulthuan to the last.	true
unit_description_short_texts_text_wh_main_unit_short_text_grn_orc_arrer_boyz	From afar, Arrer Boyz rain down arrows upon their enemies. Accuracy be damned, quantity is all.	true
unit_description_short_texts_text_wh2_main_unit_short_text_hef_cha_teclis_0	Though frail, the power of his knowledge and tactical thought is mighty indeed.	true
unit_description_short_texts_text_wh2_main_unit_short_text_hef_cha_teclis_1	Though frail, the power of his knowledge and tactical thought is mighty indeed.	true
unit_description_short_texts_text_wh2_dlc12_unit_short_text_skv_inf_warplock_jezzails_0	These ludicrously long-barrelled guns require two Skaven to operate effectively, though safety be damned!	true
unit_description_short_texts_text_wh2_dlc09_tmb_cha_liche_priest	The savage desert itself obeys the one who summons the dunes and the dead to fight for him.	true
unit_description_short_texts_text_wh_dlc03_unit_short_text_bst_centigors_great_weapons	A Centigor charges the enemy battle line, great weapon in hand, delivering oblivion to its foes.	true
unit_description_short_texts_text_wh2_dlc11_unit_short_text_cst_inf_zombie_deckhands_ror	These reanimated Norscans are Unliving proof that Manann’s will can be manifested from death as well as life.	true
unit_description_short_texts_text_wh2_main_unit_short_text_skv_cha_grey_seer_ruin_1	The air erupts with contagion and ruin, choking the enemy's lungs and savaging their bodies. 	true
unit_description_short_texts_text_wh2_main_unit_short_text_skv_cha_grey_seer_ruin_0	The air erupts with contagion and ruin, choking the enemy's lungs and savaging their bodies. 	true
unit_description_short_texts_text_wh2_dlc12_unit_short_text_lzd_mon_ancient_salamander_0	Moving just as swiftly on land as in the water, these giant, predatory reptiles spit corrosive venom before closing in for the kill.	true
unit_description_short_texts_text_wh_main_unit_short_text_vmp_mannfred_von_carstein	Cunning, devious and powerful, Mannfred von Carstein sees all before him as prizes to be claimed.	true
unit_description_short_texts_text_wh2_main_unit_short_text_def_cha_morathi_0	The mother of the Witch King is more than a match for most other magic-users on the field.	true
unit_description_short_texts_text_wh2_main_unit_short_text_def_cha_morathi_1	The mother of the Witch King is more than a match for most other magic-users on the field.	true
unit_description_short_texts_text_wh2_main_unit_short_text_skv_cha_lord_skrolk	The Great Horned Rat breathes pestilence through Skrolk, infecting the very world beneath his fetid feet.	true
unit_description_short_texts_text_wh2_dlc09_tmb_inf_skeleton_archers_ror	Existing only to serve, the Hawk-God’s blessed archers deliver his swift justice – a rain of death from above – long after their own lives have ended.	true
unit_description_short_texts_text_wh2_dlc12_unit_short_text_skv_art_warpfire_thrower_team_tech_lab_ror_0	"Doooooooooooooooom! Muwahahahaha, yes-yes!"	true
unit_description_short_texts_text_wh_main_unit_short_text_grn_night_goblins_fanatics	Night Goblins Fanatics are highly efficient killers – the ball and chain they wield sees to that!	true
unit_description_short_texts_text_wh2_main_unit_short_text_lzd_inf_chameleon_skinks_0	Unseen on the battlefield, but felt when their deadly darts bring down enemies in their droves.	true
unit_description_short_texts_text_wh_dlc05_unit_short_text_wef_forest_dragon	These wise, winged bastions of the forest will see it defended, as they have done for countless centuries.	true
unit_description_short_texts_text_wh2_dlc11_unit_short_text_cst_cha_aranessa_saltspite	The daughter of Manann himself is the most feared captain in Sartosa, as merciless as an ocean tempest.	true
unit_description_short_texts_text_wh_main_unit_short_text_emp_luminark_hysh	A weapon from the College of Light, vaporising their enemies by channelling the Wind of Hysh.	true
unit_description_short_texts_text_wh_dlc08_unit_short_text_nor_marauder_champions_great	The bigger the blade, the greater the chance the fickle, Dark Gods will notice the aspiring Champion.	true
unit_description_short_texts_text_wh2_dlc12_unit_short_text_lzd_inf_skink_red_crested_0	These Skinks are differentiated by their impressive red crests, but are also stronger and cleverer than their lesser cousins.	true
unit_description_short_texts_text_wh2_main_unit_short_text_skv_inf_clanrats_1	The cornerstone of the Skaven military, less numerous but better trained than the slave class.	true
unit_description_short_texts_text_wh2_main_unit_short_text_skv_inf_clanrats_0	The cornerstone of the Skaven military, less numerous but better trained than the slave class.	true
unit_description_short_texts_text_wh_dlc05_unit_short_text_wef_orion	Orion is the Wood Elves; he is the Winds; he is Athel Loren itself.	true
unit_description_short_texts_text_wh_dlc03_unit_short_text_bst_cygor	Plagued by visions, Cygors are cursed to see the Winds of Chaos. Naturally, this makes them mad and extremely dangerous.	true
unit_description_short_texts_text_wh2_dlc10_unit_short_text_dwf_ancestor_ghost	Called forth by the Horn of the Ancestors, ready to once again slay the foes of the Karaz Ankor.	true
unit_description_short_texts_text_wh_dlc04_unit_short_text_vmp_claw_of_nagash	Unspeakable evil energy is exuded, both empowering the Undead legions and crippling those who stand against them.	true
unit_description_short_texts_text_wh_dlc03_unit_short_text_bst_chaos_warhounds	A pack of Chaos Warhounds charging, full of bloodlust and with jaws wide, creates no purer sense of terror.	true
unit_description_short_texts_text_wh_dlc03_unit_short_text_bst_razorgor_herd	Hideously mutated and filled with hungry rage, Razorgors tear men apart in their search for food.	true
unit_description_short_texts_text_wh_main_unit_short_text_emp_helblaster_volley_gun	Helblaster Guns eviscerate opposition from a distance with a ceaseless shower of black powder fire.	true
unit_description_short_texts_text_wh_dlc03_unit_short_text_bst_malagor_the_dark_omen	Where the Crowfather treads, mayhem and destruction always follow close behind.	true
unit_description_short_texts_text_placeholder	placeholder	true
unit_description_short_texts_text_wh2_main_unit_short_text_skv_inf_clanrat_spearmen_0	Angry, teeming rats with spears to overwhelm, defend, and tear enemies from their mounts.	true
unit_description_short_texts_text_wh2_main_unit_short_text_skv_inf_clanrat_spearmen_1	Although fury and numbers count for much in a fight, a good shield cannot be overstated.	true
unit_description_short_texts_text_wh_dlc06_unit_short_text_grn_da_eight_peaks_loonies	Anticipating the will of Skarsnik, this crack squad of Goblin nutters undertakes whatever devious chicanery is required to achieve victory.	true
unit_description_short_texts_text_wh2_dlc09_tmb_cav_nehekhara_horsemen	Skeletal steeds instinctively obey the will of their riders, displaying the same supernatural discipline.	true
unit_description_short_texts_text_wh_main_unit_short_text_brt_grail_knights	The Grail Knights charge the enemy line with a furious stampede of hooves and the Lady in their thoughts.	true
unit_description_short_texts_text_wh2_main_unit_short_text_skv_art_plagueclaw_catapult	The greatest way to deliver toxic scourge is to hurl it at the enemy from a very safe distance!	true
unit_description_short_texts_text_wh2_main_unit_short_text_lzd_cha_saurus_old_blood_2	Venerated Lizardmen leaders, they exact brutal vengeance upon enemies and trespassers alike.	true
unit_description_short_texts_text_wh2_main_unit_short_text_lzd_cha_saurus_old_blood_0	Venerated Lizardmen leaders, they exact brutal vengeance upon enemies and trespassers alike.	true
unit_description_short_texts_text_wh2_main_unit_short_text_lzd_cha_saurus_old_blood_1	Venerated Lizardmen leaders, they exact brutal vengeance upon enemies and trespassers alike.	true
unit_description_short_texts_text_wh2_dlc10_unit_short_text_def_inf_blades_of_the_blood_queen_0	Like their mistress, the Blades of the Blood Queen glory in bloodshed.	true
unit_description_short_texts_text_wh_pro04_unit_short_text_nor_inf_chaos_marauders_ror	The ichor of the Gods flows through the veins of those from the God-touched wilderness.	true
unit_description_short_texts_text_wh_dlc07_unit_short_text_brt_blessed_field_trebuchet	The trebuchet - far superior to the catapult - hurls thrice-blessed stones at the enemy, crushing them with devout fury.	true
unit_description_short_texts_text_wh2_dlc09_tmb_cav_necropolis_knights	Each serpentine steed is spurred to acts of great brutality in the name of the king.	true
unit_description_short_texts_text_wh_main_unit_short_text_chs_chaos_sorcerer_death	This Chaos Sorcerer wields the Winds of Magic, using the power of death to tear limb from limb with a gesture.	true
unit_description_short_texts_text_wh2_main_unit_short_text_lzd_inf_saurus_warriors_1	Holding the line against the enemy charge, braced with shields and fierce with primordial determination.	true
unit_description_short_texts_text_wh2_main_unit_short_text_lzd_inf_saurus_warriors_0	The standard, hardy warriors of the Lizardmen battleline. Their clubs are inelegant, but effective.	true
unit_description_short_texts_text_wh2_main_unit_short_text_skv_cha_warlord_0	Their titles acquired by taking them from others, their savagery against the foe is just as unremitting.	true
unit_description_short_texts_text_wh2_main_unit_short_text_skv_cha_warlord_1	Their titles acquired by taking them from others, their savagery against the foe is just as unremitting.	true
unit_description_short_texts_text_wh_main_unit_short_text_grn_goblin_spearmen	The spear is a solid weapon; piercing and defensive. Goblins, however…	true
unit_description_short_texts_text_wh_dlc06_unit_short_text_dwf_ekrund_miners	The Miners of Mount Bloodhorn fight in memory of their fallen Hold with unmatched passion and fury.	true
unit_description_short_texts_text_wh_dlc06_unit_short_text_dwf_runesmith_ghost_01	The Master Runesmith stands by his Lord – his kin – one last time before the gods.	true
unit_description_short_texts_text_wh_main_unit_short_text_chs_chaos_knights	Chaos Knights deliver a terrifyingly powerful charge to enemy lines, particularly if armed with a lance.	true
unit_description_short_texts_text_wh2_main_unit_short_text_lzd_cha_lord_mazdamundi_0	With singular determination, Mazdamundi will enact the Great Plan - the complete extermination of the unfit races!	true
unit_description_short_texts_text_wh2_main_unit_short_text_lzd_cha_lord_mazdamundi_1	With singular determination, Mazdamundi will enact the Great Plan - the complete extermination of the unfit races!	true
unit_description_short_texts_text_wh_dlc07_unit_short_text_brt_royal_pegasus_knights	The rarest of all steeds, only the most noble of Bretonnians ride these dignified, sophisticated creatures into battle.	true
unit_description_short_texts_text_wh2_main_unit_short_text_hef_cha_mage_light	The Lore of Light banishes the forces of darkness and evil to protect its adherents, and their allies, from harm.	true
unit_description_short_texts_text_wh_main_unit_short_text_grn_night_goblin_archers_fanatics	Between bow shots, the Night Goblin Archers send their Fanatic hostages forth to cause mayhem.	true
unit_description_short_texts_text_wh2_main_unit_short_text_def_cha_dreadlord_female_0	Power, achieved through intimidation and strength on the battlefield; fear instils loyalty.	true
unit_description_short_texts_text_wh2_main_unit_short_text_def_cha_dreadlord_female_1	Power, achieved through intimidation and strength on the battlefield; fear instils loyalty.	true
unit_description_short_texts_text_wh2_main_unit_short_text_def_cha_dreadlord_female_2	Power, achieved through intimidation and strength on the battlefield; fear instils loyalty.	true
unit_description_short_texts_text_wh2_main_unit_short_text_def_cha_dreadlord_female_4	Power, achieved through intimidation and strength on the battlefield; fear instils loyalty.	true
unit_description_short_texts_text_wh2_main_unit_short_text_def_cha_dreadlord_female_5	Power, achieved through intimidation and strength on the battlefield; fear instils loyalty.	true
unit_description_short_texts_text_wh_main_unit_short_text_chs_archaon	By Khorne, by Tzeentch, Nurgle and Slaanesh, let the world come crashing down!	true
unit_description_short_texts_text_wh2_dlc11_unit_short_text_cst_inf_depth_guard	The Blood Knights of the sea are elite, armour-clad sentries to the dreaded seafaring creatures of the night.	true
unit_description_short_texts_text_wh_dlc04_unit_short_text_vmp_tithe	Zombies: shuffling, mindless, ambling towards their foes - on an unending quest for flesh.	true
unit_description_short_texts_text_wh_dlc03_unit_short_text_bst_feral_manticore	The Manticore is a killer, above all. Born of Chaos, mutations and madness, but a killer all the same.	true
unit_description_short_texts_text_wh_pro02_unit_short_text_vmp_isabella_von_carstein	As wicked as she is learned, no mortal can harm the Unliving Countess of Sylvania, for she reigns eternal!	true
unit_description_short_texts_text_wh_main_unit_short_text_dwf_cannon	A staple of Dwarfen armies, the cannon is a long-ranged, powerful weapon essential to the Dwarfen grand strategy.	true
unit_description_short_texts_text_wh2_main_unit_short_text_lzd_cha_skink_priest_0_summoned	Enacting the will of their Slann overlords, magical fury is unleashed upon the Old Ones' foes.	true
unit_description_short_texts_text_wh_main_unit_short_text_emp_empire_knights	The noble-born warriors of the Empire fight in Knightly Orders, heroic brotherhoods who ride into battle atop mighty barded warhorses.	true
unit_description_short_texts_text_wh_main_unit_short_text_brt_damsel_heavens	Those with knowledge may summon great gusts of wind or fearsome arcs of lightning to harass their enemies.	true
unit_description_short_texts_text_wh2_main_unit_short_text_hef_cha_prince_4	High Elf aristocrats are precise and calculating, and they bring this nature to the battlefield.	true
unit_description_short_texts_text_wh2_main_unit_short_text_hef_cha_prince_5	High Elf aristocrats are precise and calculating, and they bring this nature to the battlefield.	true
unit_description_short_texts_text_wh2_main_unit_short_text_hef_cha_prince_2	High Elf aristocrats are precise and calculating, and they bring this nature to the battlefield.	true
unit_description_short_texts_text_wh2_main_unit_short_text_hef_cha_prince_3	High Elf aristocrats are precise and calculating, and they bring this nature to the battlefield.	true
unit_description_short_texts_text_wh2_main_unit_short_text_hef_cha_prince_0	High Elf aristocrats are precise and calculating, and they bring this nature to the battlefield.	true
unit_description_short_texts_text_wh2_dlc10_unit_short_text_def_cav_knights_of_the_ebon_claw_0	With riders as deadly as their mounts, the Knights of the Ebon Claw are a force to be reckoned with.	true
unit_description_short_texts_text_wh_main_unit_short_text_emp_mortar	What a Mortar may lack in sheer stopping power compared to cannons, it makes up with pure vicious, explosive destruction.	true
unit_description_short_texts_text_wh_main_unit_short_text_dwf_grudge_thrower	More rudimentary than the cannon, a Grudge Thrower is still an effective long-range weapon against enemy infantry.	true
unit_description_short_texts_text_wh_main_unit_short_text_grn_goblin_archers	Goblin Archers can pepper the enemy from afar, with varying success.	true
unit_description_short_texts_text_wh_dlc06_unit_short_text_grn_night_goblin_squig_herd	One incensed Squig is enough trouble. For whosoever attracts their ire, an entire herd conjures a nightmare!	true
unit_description_short_texts_text_wh2_main_unit_short_text_hef_inf_archers_1	The bow is as natural to the High Elves as breathing; each shot is a masterpiece of death from afar.	true
unit_description_short_texts_text_wh2_main_unit_short_text_hef_inf_archers_0	The bow is as natural to the High Elves as breathing; each shot is a masterpiece of death from afar.	true
unit_description_short_texts_text_wh2_dlc12_unit_short_text_skv_cha_ikit_claw_0	The notorious tinker-rat known as Ikit Claw focuses his diabolical pursuits on building the most heinous killing-contraptions possible.	true
unit_description_short_texts_text_wh2_dlc12_unit_short_text_skv_veh_doom_flayer_ror_0	This particular spikey ball of cyclic death is the very bane of the Dwarfen race, whose little legs cannot carry themselves away fast enough!	true
unit_description_short_texts_text_wh2_main_unit_short_text_hef_cav_tiranoc_chariot	A thundering mix of beast and machine to harass enemy battlelines from range before crushing them at the charge.	true
unit_description_short_texts_text_wh_main_unit_short_text_emp_reiksguard	Equipped with the best armour and weapons, Reiksguard deliver a powerful charge, then remain amongst the throng to continue fighting.	true
unit_description_short_texts_text_wh2_main_unit_short_text_hef_inf_phoenix_guard	At the heart of the battle, in the thickest fighting, highly-trained and utterly silent.	true
unit_description_short_texts_text_wh2_main_unit_short_text_def_inf_black_guard_0	The Witch King is defended, at halberd-point, from those who would do him harm. Imagine such a thing!	true
unit_description_short_texts_text_wh_dlc04_unit_short_text_vmp_sternsmen	Only the most basic memory survives: to fight, and better than their other Undead cohorts.	true
unit_description_short_texts_text_wh_dlc08_unit_short_text_nor_mon_frost_wyrm_boss	Cold-blooded in more ways than one, this flying killer waits to pounce from behind the blinding blizzard.	true
unit_description_short_texts_text_wh_dlc04_unit_short_text_emp_stirlands_revenge	Some are drawn to war by the need for vengeance, fighting fiercely to sate their bloodlust.	true
unit_description_short_texts_text_wh2_dlc09_tmb_art_casket_of_souls	When the souls are released, they endeavour not to return without new victims to torment for eternity.	true
unit_description_short_texts_text_wh2_dlc11_unit_short_text_cst_mon_mournguls_ror	“The emptinessss… the hunger… if only I could be warm again… it’s all I think of between dark, waking dreamsss.”	true
unit_description_short_texts_text_wh_dlc03_unit_short_text_bst_chaos_spawn	An eldritch horror, the mad thrashing of its unnatural limbs sends all to their doom.	true
unit_description_short_texts_text_wh_dlc06_unit_short_text_chs_aspiring_champions	The path to Ruinous glory is strewn with the butchered remains of those who fell by the wayside.	true
unit_description_short_texts_text_wh2_main_unit_short_text_def_inf_darkshards_1	True to their name, they wither their enemies with volleys of black-tipped arrows.	true
unit_description_short_texts_text_wh2_main_unit_short_text_def_inf_darkshards_0	True to their name, they wither their enemies with volleys of black-tipped arrows.	true
unit_description_short_texts_text_wh_dlc01_unit_short_text_chs_sorcerer_lord_death	This Sorcerer Lord gleans his power from death itself, consigning his opponents to endless, tormented oblivion.	true
unit_description_short_texts_text_wh_main_unit_short_text_emp_steam_tank	From great range, a Steam Tank launches powerful shots of armour-piercing cannon fire with tremendous stopping power.	true
unit_description_short_texts_text_wh_dlc08_unit_short_text_nor_marauder_champions	All champions strive to be chosen, willing their deeds to be observed and judged.	true
unit_description_short_texts_text_wh_dlc06_unit_short_text_dwf_thane_ghost_02	“No Troll, no Orc, no sneaky grobi scum shall bar my path. This time…”	true
unit_description_short_texts_text_wh_dlc06_unit_short_text_dwf_thane_ghost_01	Centuries of shame in defeat shall be washed away ‘neath my hammer; Clan Angrund will rise again!	true
unit_description_short_texts_text_wh2_dlc11_unit_short_text_cst_cav_deck_droppers	The heinous combination of a Fell Bat and a gun-wielding zombie makes for a hideous, flying horror.	true
unit_description_short_texts_text_wh_main_unit_short_text_vmp_master_necromancer	Drifting between the living and the dead, a Master Necromancer summons Undead minions to fight enemies on his behalf.	true
unit_description_short_texts_text_wh_dlc08_unit_short_text_nor_marauders	Marauders are the rank and file of Norscan armies, perfectly placed in the centre of battle, bloodied weapon in hand.	true
unit_description_short_texts_text_wh2_dlc12_unit_short_text_lzd_mon_salamander_pack_ror_0	This shadowy tide of poisonous, scaly reptiles rarely tire and are always hungry. Always.	true
unit_description_short_texts_text_wh2_main_unit_short_text_lzd_inf_skink_cohort_0	The diligent workforce of the Lizardmen Empire, good for throwing into melee as fodder.	true
unit_description_short_texts_text_wh2_main_unit_short_text_lzd_inf_skink_cohort_1	These Skinks are trained to hurl javelins true enough to blunt a charging foe.	true
unit_description_short_texts_text_wh2_main_unit_short_text_hef_cha_loremaster_of_hoeth_0	Gifted warriors, whose skill at arms is matched by their intelligence and grasp of magic.	true
unit_description_short_texts_text_wh_main_unit_short_text_brt_men_at_arms	Though not noble or powerful like Knights, these men take great honour to take up arms in defence of home.	true
unit_description_short_texts_text_wh2_dlc12_unit_short_text_skv_art_ratling_gun_team_tech_lab_ror_0	"You see… only your imminent death, haha, yes-yes!"	true
unit_description_short_texts_text_wh_dlc04_unit_short_text_vmp_corpse_cart_balefile	Infernal flames belch from dismal braziers, permeating the air with fragments of magic-confounding Warpstone.	true
unit_description_short_texts_text_wh2_dlc10_unit_short_text_hef_cav_the_fireborn_0	The mighty deeds of the Fireborn are spoken of in hushed tones by all the princes of Caledor.	true
unit_description_short_texts_text_wh2_main_unit_short_text_hef_mon_phoenix_flamespyre_boss	The rarely-appearing Phoenix matriarch is a creature of Hekarti, awoken into this world through the heart of a raging volcano.	true
unit_description_short_texts_text_wh2_main_unit_short_text_skv_inf_night_runners_1	Appearing as if from the earth itself, peppering opponents with relentless, deadly sling-fire.	true
unit_description_short_texts_text_wh2_main_unit_short_text_skv_inf_night_runners_0	These secretive warriors work best when deployed away from the main host, striking at flanks and unsecured or vulnerable places.	true
unit_description_short_texts_text_wh_dlc04_unit_short_text_vmp_vlad_von_carstein	Through life, death, and Undeath, the first and greatest of the Vampire Counts pursues the throne; it is his by right!	true
unit_description_short_texts_text_wh_dlc01_unit_short_text_chs_gorebeast_chariot	Those who are not gored by the rolling spikes of this beast chariot are thrown to a clumsy, painful demise.	true
unit_description_short_texts_text_wh2_dlc10_unit_short_text_hef_cha_alith	Alith Anar is the Shadow King, a revenant who seeks the grisly death of every Dark Elf in retribution for Malekith’s sins.	true
unit_description_short_texts_text_wh2_dlc09_tmb_cha_khatep	The Liche Lord, ancient beyond memory, wanders the deserts in search of powerful artefacts to restore his beloved kingdom to its former glory.	true
unit_description_short_texts_text_wh_dlc05_unit_short_text_wef_wardancers_1	When deadly Asrai spears are wielded, the war dance is an intricate performance ending in the foes' death.	true
unit_description_short_texts_text_wh_dlc05_unit_short_text_wef_wardancers_0	Floating and weaving through the battle line; an expressive demonstration of violence.	true
unit_description_short_texts_text_wh_main_unit_short_text_vmp_necromancer	Necromancers summon the dead to fight for them, hurling risen cadavers to join the fray in their name. 	true
unit_description_short_texts_text_wh2_main_unit_short_text_lzd_mon_bastiladon_0	Mighty, hulking reptiles, these 'Living Bastions' are wild and untamed. Better watch out!	true
unit_description_short_texts_text_wh2_main_unit_short_text_lzd_mon_bastiladon_1	Carried atop the mightiest of beasts, the Revivification Crystal regenerates and heals combat-damaged units.	true
unit_description_short_texts_text_wh2_main_unit_short_text_lzd_mon_bastiladon_2	The Solar Engine can disintegrate enemies with a beam of pure sunlight.	true
unit_description_short_texts_text_wh2_dlc09_tmb_inf_nehekhara_warriors_ror	The faceless God of the Underworld guides dead souls to the other life – some at the price of their service in battle.	true
unit_description_short_texts_text_wh_main_unit_short_text_emp_state_crossbowmen	The thudding crossbow bolts pack a punch that can bring down most foes.	true
unit_description_short_texts_text_wh2_dlc09_tmb_cha_settra	Settra ruled over the most magnificent realm ever known; now he will see it restored.	true
unit_description_short_texts_text_wh2_dlc10_unit_short_text_def_cha_supreme_sorceress_death	Death stalks all that come to Ghrond, and those who wield the power of Shyish are more adept than most in murder's arcane arts.	true
unit_description_short_texts_text_wh_main_unit_short_text_emp_outriders	Fast and dependable, an Outrider can be in one place to fire, then be in another to fire again moments later.	true
unit_description_short_texts_text_wh2_dlc12_unit_short_text_skv_veh_doomwheel_tech_lab_ror_0	"…and Hell, quite literally, followed with it."	true
unit_description_short_texts_text_wh2_dlc09_tmb_cha_arkhan	"Nagash must rise, or our realms of silence will fall."	true
unit_description_short_texts_text_wh2_main_unit_short_text_skv_inf_skavenslave_slingers_0	From a position of relative safety, slings enable them to watch their peers march to their doom.	true
unit_description_short_texts_text_wh2_main_unit_short_text_def_inf_harpies	With savage claws and malicious temperament, to rip through enemies with grim delight.	true
unit_description_short_texts_text_wh_main_unit_short_text_vmp_vargheists	A Vampire reduced and twisted to savagery, Vargheists swoop in from above and rip battle lines to pieces.	true
unit_description_short_texts_text_wh_main_unit_short_text_emp_demigryph_knights	More stalwart and powerful than even the riders atop them, demigryphs deliver a monstrous charge into enemy battle lines.	true
unit_description_short_texts_text_wh2_main_unit_short_text_skv_inf_plague_monks	Feeling no pain, they throw themselves into battle, paying little heed to what awaits them.	true
unit_description_short_texts_text_wh_dlc03_unit_short_text_bst_bray_shaman_beasts	Cloaked in the power of the beast, the Bray-Shaman uses his primal mutations to exert greater strength.	true
unit_description_short_texts_text_wh2_dlc12_unit_short_text_lzd_cav_terradon_riders_ror_0	The keenest eyes, the sharpest reflexes, the coldest of hearts.	true
unit_description_short_texts_text_wh2_main_unit_short_text_hef_cav_silver_helms_0	The stuff of legend, devastating enemy lines with a staggering charge.	true
unit_description_short_texts_text_wh2_main_unit_short_text_hef_cav_silver_helms_1	With stout shields and resolute temperaments, resisting the charge of any who dare stand against them.	true
unit_description_short_texts_text_wh2_main_unit_short_text_skv_inf_death_runners_0	Understanding from the outset that yours is a suicide mission focuses the murine mind on the murderous task at hand.	true
unit_description_short_texts_text_wh_main_unit_short_text_vmp_skeletons	Little more than shuffling bones with swords and spears, Skeletons perform a dutiful, if not exemplary, job in the battle lines.	true
unit_description_short_texts_text_wh2_dlc10_unit_short_text_def_inf_sisters_of_slaughter_0	The Sisters of Slaughter are creatures of instinct, impossible to predict and unfathomably deadly.	true
unit_description_short_texts_text_wh_main_unit_short_text_grn_orc_shaman	Shamans practise the art of annoyance - peppering their enemies with frustrating, painful and distracting spells.	true
unit_description_short_texts_text_wh2_dlc10_unit_short_text_def_inf_sisters_of_the_singing_doom_0	The sisters specialise in the three D's: doom, death and destruction.	true
unit_description_short_texts_text_wh_main_unit_short_text_vmp_wight_king	Weapons bursting with dark energy, Wight Kings are monstrous fighters, more powerful than a dozen lesser ghouls.	true
unit_description_short_texts_text_wh_main_unit_short_text_chs_marauder_horsemen	These men are possessed, packing a decisive punch with a touch of insanity.	true
unit_description_short_texts_text_wh_main_unit_short_text_grn_orc_big_uns	The hardest-hitting mobs in a tribe, Big 'Uns are well placed in melee, where they happily smash their enemies apart.	true
unit_description_short_texts_text_wh2_dlc11_unit_short_text_cst_mon_necrofex_colossus_ror	The terror of Bogenhafen leaves nothing living in its wake, driven by a dark appetite for murder and destruction.	true
unit_description_short_texts_text_wh_dlc08_unit_short_bst_mon_cygor_boss	The Soul-Eater brothers are bigger, stronger, and angrier than regular Cygors, needing little provocation to start hurling their boulders indiscriminately.	true
unit_description_short_texts_text_wh2_dlc09_tmb_veh_skeleton_chariot	An unearthly mixture of wood, metal and bone to savage the foe in rending, powerful strikes.	true
unit_description_short_texts_text_wh2_dlc09_tmb_veh_skeleton_chariot_archers	From the chariot's elevated platform, archers are offered unparalleled opportunities to fire on the enemy.	true
unit_description_short_texts_text_wh_main_unit_short_text_grn_goblin_wolf_chariot	Chariots deliver devastating charges to the front lines; the wolf steeds that draw them are ferocious in battle.	true
unit_description_short_texts_text_wh_main_unit_short_text_grn_savage_orc_big_uns	Savage Orcs alone are a terrifying prospect to face. Add Big 'Uns to the mix and things get really nasty very quickly.	true
unit_description_short_texts_text_wh_main_unit_short_text_dwf_thunderers	Although new, and therefore suspect, a Thunderer's handgun can punch through the heaviest of armour at short range.	true
unit_description_short_texts_text_wh2_dlc12_unit_short_text_skv_inf_warplock_jezzails_tech_lab_ror_0	These crack Jezzail operators are the most accurate among their already-deadly kind; best keep your head down if you value your eyesight!	true
unit_description_short_texts_text_wh_dlc03_unit_short_text_bst_centigors	Hybrid man-beasts, raging at fate, Centigors bring their anger to bear upon anything in their path.	true
unit_description_short_texts_text_wh2_dlc10_unit_short_text_def_cha_sorceress_death	Death stalks all that come to Ghrond, and those who wield the power of Shyish are more adept than most in murder's arcane arts.	true
unit_description_short_texts_text_wh2_main_unit_short_text_lzd_cha_skink_chief_2	Where he hunts, the air is alive with poison darts, fired seemingly from nowhere at all.	true
unit_description_short_texts_text_wh_main_unit_short_text_dwf_irondrakes_torpedos	These Irondrakes wield drakeguns that fire the deadly Trollhammer Torpedo - a spiky cone of death - at unfortunate foes.	true
unit_description_short_texts_text_wh2_main_unit_short_text_lzd_cha_skink_chief_3	Where he hunts, the air is alive with poison darts, fired seemingly from nowhere at all.	true
unit_description_short_texts_text_wh2_main_unit_short_text_lzd_cha_skink_chief_0	Where he hunts, the air is alive with poison darts, fired seemingly from nowhere at all.	true
unit_description_short_texts_text_wh2_main_unit_short_text_lzd_cha_skink_chief_1	Where he hunts, the air is alive with poison darts, fired seemingly from nowhere at all.	true
unit_description_short_texts_text_wh_dlc07_brt_cav_royal_hippogryph_knights	A hippogryph is no easy prize, but its power in battle makes the effort to tame one worth it.	true
unit_description_short_texts_text_wh_main_unit_short_text_chs_hellcannon	The Hellcannon has a deadly sentience, firing bolts of eldritch fury over great distances.	true
unit_description_short_texts_text_wh_main_unit_short_text_vmp_fell_bats	Fell Bats fall upon their enemies in a seething mass; in numbers, they become overwhelming.	true
unit_description_short_texts_text_wh2_dlc11_unit_short_text_cst_inf_depth_guard_ror	Like the Bloody Reaver upon which they serve, the Deck Guard are forged with the powerful magic of Noctilus himself.	true
unit_description_short_texts_text_wh2_main_unit_short_text_def_mon_war_hydra_0_boss	This massive, multi-headed menace of dense scales can maul many victims at once, and does so with a terrifying ravenousness.  	true
unit_description_short_texts_text_wh2_main_unit_short_text_def_inf_black_ark_corsairs_1	Defeat and conquest, at the end of a quarrel.	true
unit_description_short_texts_text_wh2_main_unit_short_text_def_inf_black_ark_corsairs_0	The cut and thrust of melee is child's play to those trained on tumultuous seas.	true
unit_description_short_texts_text_wh_dlc01_unit_short_text_chs_sorcerer_lord_fire	The powerful Sorcerer Lord summons up pillars of flame that sear the enemy to their very core.	true
unit_description_short_texts_text_wh_main_unit_short_text_vmp_hexwraiths	Hexwraiths charge, spectral, through mountains in search of their prey - a battle line is a trifling thing for their devastating attack.	true
unit_description_short_texts_text_wh_dlc07_brt_cav_royal_pegasus_knights	The rarest of all steeds, only the most noble of Bretonnians ride these dignified, sophisticated creatures into battle.	true
unit_description_short_texts_text_wh_dlc01_unit_short_text_chs_chaos_sorcerer_lord_shadows	This Sorcerer Lord can reach into the very minds of his adversaries, ripping thoughts apart as easily as undoing a knot.	true
unit_description_short_texts_text_wh_dlc08_unit_short_text_nor_marauder_warwolves_chariot	With axe-flinging Marauders in tow, drooling and crazed Ice Wolves can pull chariots with overwhelming speed.	true
unit_description_short_texts_text_wh2_main_unit_short_text_def_inf_dreadspears_0	The bulk of Dark Elf armies, with spears as unwavering as their pride.	true
unit_description_short_texts_text_wh2_dlc11_unit_short_text_cst_cha_fleet_admiral	The hiss of the Vampire Admiral’s orders spurs an Undead crew to enact their master’s sinister will.	true
unit_description_short_texts_text_wh_main_unit_short_text_grn_savage_orc_boar_boy_big_uns	A boar-mounted Savage Orc Big ‘Un has a powerful charge and a really unpleasant line in melee skills.	true
unit_description_short_texts_text_wh2_dlc12_unit_short_text_skv_cha_warlock_master_0	Cunning overseers, whose job it is to manage and well, steal any credit that may be due an inventive Warlock Engineer.	true
unit_description_short_texts_text_wh2_dlc09_tmb_cav_necropolis_knights_ror	Channelling her ancient, ageless fury, the Asp-Goddess’ chosen riders bite with her deadly venom.	true
unit_description_short_texts_text_wh2_dlc11_unit_short_text_vmp_von_carstein_vampire_lord	Though their origins are shrouded in mystery, Vlad and his descendants now swarm across the world, bringing their gift of death to all!	true
unit_description_short_texts_text_wh2_main_unit_short_text_lzd_mon_carnosaur_0_boss	The mightiest and most legendary of Feral Carnosaurs has roamed Lustria for centuries, devouring all unlucky enough to encounter it.	true
unit_description_short_texts_text_wh2_dlc09_tmb_cav_nehekhara_horsemen_ror	Emerging from the desert dust clouds, these horsemen come charging out of the storm, and death rides with them.	true
unit_description_short_texts_text_wh_dlc08_unit_short_text_nor_marauder_warwolves	The icy northern reaches of frozen purgatory are haunted by howls of the ravenous.	true
unit_description_short_texts_text_wh_dlc07_unit_short_text_brt_prophetess_beasts	Not just to command nature, but to range animals' primal rage against your foe? That is true power.	true
unit_description_short_texts_text_wh_dlc05_unit_short_text_wef_great_eagle	When the skies are dark and the need is great, these noble avians come to the aid of their Elven friends.	true
unit_description_short_texts_text_wh_dlc06_unit_short_text_grn_spider_hatchlings	Although a fraction of the size of their fully-grown sisters, newly-hatched Arachnaroks are every bit as deadly.	true
unit_description_short_texts_text_wh_dlc01_unit_short_text_chs_dragon_ogre_shaggoth	The Shaggoth tower over the common man, casting fearsome shadows matched only by the seismic devastation they cause.	true
unit_description_short_texts_text_wh2_main_unit_short_text_lzd_cav_horned_ones_0	Much rarer than other Cold Ones, these virtually-extinct Lustrian warriors fight with preternatural swiftness that belies their size.	true
unit_description_short_texts_text_wh_dlc06_unit_short_text_dwf_norgrimlings_ironbreakers	Though they hail from Clan Norgrimling, the fealty of these Ironbreakers is sworn to the glory of the Dwarfs.	true
unit_description_short_texts_text_wh_main_unit_short_text_dwf_hammerers	Elite, hardened warriors, Hammerers thrive amongst the melee with warhammer in hand, smashing the unprepared to pieces.	true
unit_description_short_texts_text_wh_dlc01_unit_short_text_chs_sorcerer_lord_metal	When subjected to his power, all before this Sorcerer Lord are sliced, diced and desiccated .	true
unit_description_short_texts_text_wh2_main_unit_short_text_skv_inf_stormvermin_1	Recognisably dark-furred, the Skaven military elite fight with a proud zeal unique to their class.	true
unit_description_short_texts_text_wh2_main_unit_short_text_skv_inf_stormvermin_0	Recognisably dark-furred, the Skaven military elite fight with a proud zeal unique to their class.	true
unit_description_short_texts_text_wh_main_unit_short_text_grn_arachnarok	With a team of Goblins upon its back, the Arachnarok's sheer enormity strikes fear into the hearts of all who face it.	true
unit_description_short_texts_text_wh_dlc03_unit_short_text_bst_beastlord	Savage masters of the battlefield, Beastlords join the fray with axes in hand and death in mind.	true
unit_description_short_texts_text_wh_main_unit_short_text_chs_chaos_lord	Chaos Lords take their blood-drenched blades into battle. Fighting endlessly, they are merciless and unrelenting in the fray.	true
unit_description_short_texts_text_wh2_main_unit_short_text_def_cav_dark_riders_1	Their shields ensure that these riders can get in amongst the fray and remain there.	true
unit_description_short_texts_text_wh2_main_unit_short_text_def_cav_dark_riders_0	Fast and nimble, dodging enemy fire to deliver incisive hit-and-run charges to enemy lines.	true
unit_description_short_texts_text_wh2_main_unit_short_text_def_cav_dark_riders_2	Being everywhere and nowhere is their signature skill, with volleys of fire to harass the foe.	true
unit_description_short_texts_text_wh2_main_unit_short_text_def_inf_witch_elves_0	Crazed by poisonous concoctions, their dual daggers lacerate and shred for the Bloody-handed God.	true
unit_description_short_texts_text_wh2_dlc11_unit_short_text_def_cha_lokhir_fellheart	The doom-bringing Krakenlord of Karond Kar fights as naturally as he reads the oceanic temper.	true
unit_description_short_texts_text_wh2_dlc10_unit_short_text_hef_inf_keepers_of_the_flame_0	These silent sentinels guard the Shrine of Asuryan.	true
unit_description_short_texts_text_wh_dlc08_unit_short_text_nor_skin_wolf_werekin	Shredded flaps of skin, clinging to a vicious humanoid wolf-thing, are all that remains of these former champions.	true
unit_description_short_texts_text_wh2_dlc11_unit_short_text_cst_cav_deck_droppers_bombers	Beware the Deck Droppers’ black powder bombs released indiscriminately – if somewhat inaccurately – from above!	true
unit_description_short_texts_text_wh2_dlc09_tmb_inf_skeleton_archers	These desiccated husks remember how to shoot; a hail of endless death to thin the foe's numbers.	true
unit_description_short_texts_text_wh2_main_unit_short_text_def_inf_bleakswords_0	Schooled in slaughter through a lifetime of survival.	true
unit_description_short_texts_text_wh2_dlc11_unit_short_text_cst_mon_animated_hulks	Walking, rotting Ogre flesh fused with ship debris and sea monsters makes for truly twisted abominations.	true
unit_description_short_texts_text_wh_pro04_unit_short_text_chs_mon_chaos_spawn_ror	Former Champions with mutant gifts received in the Realm of Chaos itself, summoned back to terrorise the mortal world.	true
unit_description_short_texts_text_wh_main_unit_short_text_grn_orc_warboss	Pure muscle and rage, Warbosses devastate enemies with their brutal melee attacks.	true
unit_description_short_texts_text_wh2_main_unit_short_text_lzd_cav_cold_one_spearriders_0	A spear charge from atop a horde of Cold Ones will do significant damage to anyone in its path.	true
unit_description_short_texts_text_wh2_main_unit_short_text_lzd_cav_cold_one_spearriders_1	A pack of Cold Ones, ridden with skill, can charge powerfully into melee and remain there for some time.	true
unit_description_short_texts_text_wh2_dlc11_unit_short_text_cst_inf_zombie_deckhands	These Undead mariners are competent crewmen and relentless fighters, making them ideal pirates.	true
unit_description_short_texts_text_wh_main_unit_short_text_dwf_irondrakes	The Irondrakes wield drakeguns, firing bursts of alchemical fury over anyone in their path.	true
unit_description_short_texts_text_wh_dlc06_unit_short_text_grn_night_goblin_squig_hoppers	It takes a certain kind of insanity to ride a rage-frothed Squig and bounce into the fray.	true
unit_description_short_texts_text_wh_main_unit_short_text_dwf_gyrobombers	From above, the bomber pilot releases a payload of high-yield explosives that wreak havoc on enemy lines.	true
unit_description_short_texts_text_wh_main_unit_short_text_emp_state_handgunners	Volleys of withering fire reduce any would-be army to a riddled, desperate band.	true
unit_description_short_texts_text_wh_main_unit_short_text_grn_black_orcs	Black Orcs are more disciplined, armoured and deadly than other Orcs, ripping through enemies with their heavy weapons for fun.	true
unit_description_short_texts_text_wh_dlc06_unit_short_text_dwf_skyhammer	The mountains and caverns ring with Greenskin screams when these elite Gyrobombers unleash their payloads.	true
unit_description_short_texts_text_wh_pro04_unit_short_text_nor_mon_marauder_warwolves_ror	Ravenous beasts summoned from the Realm of Chaos itself, slobbering with an insatiable hunger to tear at living flesh.	true
unit_description_short_texts_text_wh_main_unit_short_text_grn_rock_lobber	Greenskins love chucking fings at the enemy; the rock lobber allows them to throw bigger fings further.	true
unit_description_short_texts_text_wh_main_unit_short_text_emp_state_halberdiers	Halberdiers are stalwart defenders, able to hold the line behind a wall of Halberds, cutting enemies to ribbons.	true
unit_description_short_texts_text_wh_dlc06_unit_short_text_grn_venom_queen	Poisonous, corrosive venom dripping from her fearsome jaws, she first ensnares her victims in a web of dense, sticky silk.	true
unit_description_short_texts_text_wh2_main_unit_short_text_hef_inf_white_lions_of_chrace_0	Charged to defend the Phoenix King to the last, they cut their opponents down with their savage great axes.	true
unit_description_short_texts_text_wh2_dlc11_unit_short_text_cst_cha_luthor_harkon	Served by the reanimated corpses of shipwrecked unfortunates, the Pirate King is a plague upon the world’s seas.	true
unit_description_short_texts_text_wh2_dlc10_unt_short_text_dwf_inf_giant_slayers_0	Great warriors and doomseekers who have unsuccessfully found death thus far... even against Giants.	true
unit_description_short_texts_text_wh_main_unit_short_text_dwf_quarrellers	A volley of Dwarfen crossbow bolts will travel far and hit hard, particularly against the lightly armoured. 	true
unit_description_short_texts_text_wh2_dlc10_unt_short_text_hef_inf_shadow_walkers_0	As well as commanding bands of Shadow Warriors, Shadow-walkers form an elite retinue of Nagarythe’s finest to accompany Alith Anar into battle.	true
unit_description_short_texts_text_wh2_dlc09_tmb_art_screaming_skull_catapult	What’s scarier than being bombarded with skulls from a distance? Why, if they are on fire and screaming in anguish of course!	true
unit_description_short_texts_text_wh_main_unit_short_text_grn_savage_orcs	Savage Orcs lay into their enemies with clubs, axes or whatever is needed to cause as much damage as possible.	true
unit_description_short_texts_text_wh_dlc08_unit_short_text_nor_fimir_warriors_great	When hoping for the fleeting, fickle favour of the Ruinous Ones, carry a really big mace.	true
unit_description_short_texts_text_wh_main_unit_short_text_dwf_organ_gun	Should the enemy get too close, an Organ Gun can decimate entire ranks with a well timed blast.	true
unit_description_short_texts_text_wh2_dlc10_unit_short_text_def_cha_crone	Greatest of all the Brides of Khaine, the many ways of murder are Hellebron's to command.	true
unit_description_short_texts_text_wh_main_unit_short_text_vmp_dire_wolves	A pack of Dire Wolves is a lacerating mess of teeth in the melee, effective against enemy infantry.	true
unit_description_short_texts_text_wh2_main_unit_short_text_lzd_cha_skink_priest_beasts_2	Enacting the will of their Slann overlords, magical fury is unleashed upon the Old Ones' foes.	true
unit_description_short_texts_text_wh2_main_unit_short_text_lzd_cha_skink_priest_beasts_3	Enacting the will of their Slann overlords, magical fury is unleashed upon the Old Ones' foes.	true
unit_description_short_texts_text_wh2_main_unit_short_text_lzd_cha_skink_priest_beasts_0	Enacting the will of their Slann overlords, magical fury is unleashed upon the Old Ones' foes.	true
unit_description_short_texts_text_wh2_main_unit_short_text_lzd_cha_skink_priest_beasts_1	Enacting the will of their Slann overlords, magical fury is unleashed upon the Old Ones' foes.	true
unit_description_short_texts_text_wh2_main_unit_short_text_skv_inf_skavenslaves_0	In this lawless, miserable world the weak, or the merely out-manoeuvred, are either killed or put to back-breaking toil by the strong.	true
unit_description_short_texts_text_wh_main_unit_short_text_emp_pistoliers	The Pistoliers are standard ranged cavalry, their pistols packing an effective punch whilst maintaining mobility.	true
unit_description_short_texts_text_wh2_dlc11_unit_short_text_cst_cha_fleet_captain	Wielding her cursed cutlass, this swashbuckling Vampire cripples and kills all who dare oppose her.	true
unit_description_short_texts_text_wh2_main_unit_short_text_skv_inf_skavenslave_spearmen_0	A spear may mean they fight a little longer or better, but it only delays their inevitable demise.	true
unit_description_short_texts_text_wh2_dlc12_unit_short_text_skv_inf_ratling_gun_0	The very latest technology Clan Skryre have to offer requires a special breed of suicidal nutters to operate it effectively.	true
unit_description_short_texts_text_wh2_dlc12_unit_short_text_lzd_inf_saurus_warriors_ror_0	Ignominious defeat at perfidious Skaven hands has only strengthened the already-steely resolve of Chaqua's surviving Saurus.	true
unit_description_short_texts_text_wh_dlc06_unit_short_text_dwf_goblobber	When a grudge-writ rock is unavailable, live Goblin ammunition is just as good.	true
unit_description_short_texts_text_wh_main_unit_short_text_chs_chaos_spawn	Monsters of mutated chaos, these altered beasts rain savage blows upon the foe.	true
unit_description_short_texts_text_wh2_dlc12_unit_short_text_skv_veh_doom_flayer_0	It's not quite as bad as it sounds… In fact, it's far, far worse. Prepare to die.	true
unit_description_short_texts_text_wh_dlc08_unit_short_text_nor_frost_wyrm	Frost-Wyrms dwell in lairs below the frozen tundra, still as death until ascending for murderous activities. 	true
unit_description_short_texts_text_wh_main_emp_cav_empire_knights	The noble-born warriors of the Empire fight in Knightly Orders, heroic brotherhoods who ride into battle atop mighty barded warhorses.	true
unit_description_short_texts_text_wh_dlc08_unit_short_text_nor_cha_arzik	"Understand, mortals, each of your petty champion's ploys are just pieces in my Master's Great Game!"	true
unit_description_short_texts_text_wh_main_unit_short_text_grn_orc_boyz	Orc Boyz lack the strength of Big 'Uns, but their tenacity and endurance in battle is well respected.	true
unit_description_short_texts_text_wh2_main_unit_short_text_lzd_cha_slann_mage_priest_campaign_0	These Slann mystics bring ruin to the foe's armies and devastation to its cities.	true
unit_description_short_texts_text_wh_pro04_unit_short_text_brt_cav_knights_of_the_realm_ror	From the home of the first great companion, Thierulf the Lionhearted, come the most ferocious of Bretonnia’s Knights.	true
unit_description_short_texts_text_wh2_dlc09_tmb_mon_tomb_scorpion	They can burrow for leagues when summoned, bursting into battle with a blast of sand and snapping limbs.	true
unit_description_short_texts_text_wh2_dlc11_unit_short_text_cst_inf_syreens	Their howls turn even the bravest sailors stark white, spearing their souls like a lance through the heart.	true
unit_description_short_texts_text_wh_dlc06_unit_short_text_dwf_master_engineer_ghost_01	Sheer weight of numbers forced us back, against our best efforts to remain stalwart. That will not happen again. I vow it.	true
unit_description_short_texts_text_wh2_dlc12_unit_short_text_skv_veh_doomwheel_ror_0	The dread Wheelz crush those caught 'neath their spikey-tracked engines of death!	true
unit_description_short_texts_text_wh_dlc07_unit_short_text_brt_foot_squires	Every Squire dreams of becoming a Knight, and every Knight dreams of having a better Squire…	true
unit_description_short_texts_text_wh_dlc08_unit_short_text_nor_mon_frost_wyrm_ror	The closest cousin of the Scion of the Cold-Void has equally murderous instincts.	true
unit_description_short_texts_text_wh2_dlc10_unit_short_text_def_cav_slaanesh_harvesters_0	Slaanesh has an insatiable appetite for Elven souls, and the Harvesters are only too happy to oblige!	true
unit_description_short_texts_text_wh_dlc08_unit_short_text_wef_forest_dragon_boss	The forest’s champion will not shy away from coming to the Great Oak’s aid, viciously confronting any who dare attack it.	true
unit_description_short_texts_text_wh_dlc04_unit_short_text_emp_tattersouls	They thrive in melee, with the unbreakable spirit that comes from accepting death.	true
unit_description_short_texts_text_wh_dlc04_unit_short_text_emp_zintlers_reiksguard	Above their peers, Zintler's men charge down enemy lines with a destructive fury that makes the earth shake.	true
unit_description_short_texts_text_wh2_dlc11_unit_short_text_vmp_strigoi_vampire_lord	Large and heavily-set, Ushoran's descendants are the animalistic blunt instruments of the Vampire race.	true
unit_description_short_texts_text_wh_dlc04_unit_short_text_emp_sigmars_sons	The heart of any battle and the embodiment of Sigmar's will as they heroically engage the foe.	true
unit_description_short_texts_text_wh2_main_unit_short_text_lzd_cha_skink_priest_heavens_3	Enacting the will of their Slann overlords, magical fury is unleashed upon the Old Ones' foes.	true
unit_description_short_texts_text_wh2_main_unit_short_text_lzd_cha_skink_priest_heavens_2	Enacting the will of their Slann overlords, magical fury is unleashed upon the Old Ones' foes.	true
unit_description_short_texts_text_wh2_main_unit_short_text_lzd_cha_skink_priest_heavens_1	Enacting the will of their Slann overlords, magical fury is unleashed upon the Old Ones' foes.	true
unit_description_short_texts_text_wh2_main_unit_short_text_lzd_cha_skink_priest_heavens_0	Enacting the will of their Slann overlords, magical fury is unleashed upon the Old Ones' foes.	true
unit_description_short_texts_text_wh2_main_unit_short_text_lzd_mon_bastiladon_blessed_2	Puissant Bastiladons marked for greatness by the Old Ones. 	true
unit_description_short_texts_text_wh2_dlc11_unit_short_text_cst_cha_mourngul_haunter	Malice personified, a Haunter never knows relief from its manic, all-consuming hunger.	true
unit_description_short_texts_text_wh_main_unit_short_text_emp_celestial_wizard	Celestial Wizards draw strength from the Comet of Power, calling devastating heavenly magic to rend enemies asunder. 	true
unit_description_short_texts_text_wh_dlc04_unit_short_text_vmp_corpse_cart	Devilish chariots imbued with dark and eldritch power, driving the Undead to greater, more macabre acts.	true
unit_description_short_texts_text_wh2_dlc10_unit_short_text_def_cha_supreme_sorceress_fire	The hot, searing Red Wind blows down from the north to inflame passions and, if not used carefully, the spellcasters themselves.	true
unit_description_short_texts_text_wh_dlc03_unit_short_text_bst_bray_shaman_death	Death whispers to the Bray-Shaman, who speaks the words to his enemies with hideous, incorporeal power.	true
unit_description_short_texts_text_wh2_dlc10_unit_short_text_def_cha_supreme_sorceress_dark	Is there any greater dealer of death than a Sorceress at the height of her powers? Perhaps… but none will take as great a joy in unleashing it.	true
unit_description_short_texts_text_wh_pro04_unit_short_text_bst_inf_minotaurs_ror	The towns of men are but larders of flesh for the followers of the ways of Ragush, ravager of Kalkengard.	true
unit_description_short_texts_text_wh2_dlc11_unit_short_text_vmp_blood_dragon_vampire_lord	Fallen Imperial knights, risen again to serve their ancient Bloodline for eternity.	true
unit_description_short_texts_text_wh2_dlc11_unit_short_text_cst_cav_questing_knights	Once defined by their ability to face trials and overcome hardships, now their only quest is to attend to the vengeful Madame-Captain.	true
unit_description_short_texts_text_wh2_main_unit_short_text_lzd_cav_cold_ones_feral_0_summoned	Untamed Cold Ones are far too unpredictable to be ridden into battle; simply point them at the foe and stay out of their way!	true
unit_description_short_texts_text_wh2_dlc10_unit_short_text_def_cha_supreme_sorceress_beasts	A Supreme Sorceress excels at not just Dark Magic, but also the ability to control and summon beasts - a mistress of Ghur.	true
unit_description_short_texts_text_wh2_dlc12_unit_short_text_lzd_inf_skink_red_crested_ror_0	Having survived the Skaven onslaught that destroyed their home, now they follow the Serpent-God, to the very End Times if necessary.	true
unit_description_short_texts_text_wh_pro01_unit_short_text_dwf_grombrindal	The White Dwarf is a legendary figure - the mightiest living Dawi warrior.	true
unit_description_short_texts_text_wh_dlc07_unit_short_text_brt_peasant_mob	Rejoice! For a Knight of Bretonnia provides your shield…	true
unit_description_short_texts_text_wh_dlc08_unit_short_text_nor_skin_wolves	Skin Wolves take to the battlefield to glut themselves on the raw and dripping gore of their victims.	true
unit_description_short_texts_text_wh2_dlc12_unit_short_text_skv_inf_clanrats_ror_0	These Clanrats' sport nasty, improvised tailblades that are all the more vicious for their homemade ingenuity.	true
unit_description_short_texts_text_wh_dlc07_unit_short_text_brt_damsel_life	Proponents of the Lore of Life protect and heal friendly troops and allies, whilst forestalling their foes at every turn.	true
unit_description_short_texts_text_wh_dlc08_unit_short_text_nor_cha_kihar	A most evil Sorcerer, known for tormenting his foes by ensuring that death only comes to them after great suffering.	true
unit_description_short_texts_text_wh_dlc04_unit_short_text_emp_flagellants	Wading into battle, crazed and unable to be broken, facing their doom with furious acceptance.	true
unit_description_short_texts_text_wh_main_unit_short_text_emp_karl_franz	For the Empire! For Sigmar! For GLORY!	true
unit_description_short_texts_text_wh2_main_unit_short_text_skv_inf_clanrat_spearmen_1_summoned	Although fury and numbers count for much in a fight, a good shield cannot be overstated.	true
unit_description_short_texts_text_wh_dlc04_unit_short_text_vmp_strigoi_ghoul_king	Though deformed and reduced by time, they remain savage warriors and masters of the dead.	true
unit_description_short_texts_text_wh_dlc05_unit_short_text_wef_glade_lord	Above pride, vanity and selfish ego there is only Athel Loren.	true
unit_description_short_texts_text_wh2_main_unit_short_text_hef_mon_great_eagle_summoned	Firm allies for millennia, these majestic birds aid the Elves by swooping onto enemy lines and clawing them apart.	true
unit_description_short_texts_text_wh_dlc04_unit_short_text_emp_templehof_luminark	The Wind is stored and harnessed, resulting in the bursting forth of a lethal energy.	true
unit_description_short_texts_text_wh2_dlc11_unit_short_text_cst_cha_gunnery_wight	These former marksmen and artillerymen are as obsessed with gunpowder in death as they were in life.	true
unit_description_short_texts_text_wh_pro04_unit_short_text_nor_mon_war_mammoth_ror	A legendary destroyer of both the physical and metaphysical, annihilating souls by trampling foes into an unrecognisable pulp.	true
unit_description_short_texts_text_wh_dlc08_unit_short_text_nor_war_mammoth	This twisted and enraged beast is a terrifying totem of might and power.	true
unit_description_short_texts_text_wh2_dlc12_unit_short_text_skv_inf_warplock_jezzails_ror_0	They may be literally falling apart at the seams, but this rag-tag band share a dead-eyed accuracy that's hard to beat.	true
unit_description_short_texts_text_wh_dlc04_unit_short_text_vmp_chillgheists	A semi-spectral force that severs mortal souls from their corporeal hosts.	true
unit_description_short_texts_text_wh_dlc05_unit_short_text_wef_branchwraith	The handmaidens of the Ancients protect their former kingdom from harm, all the while plotting against its usurpers…	true
unit_description_short_texts_text_wh_dlc06_unit_short_text_dwf_bolt_thrower	More rudimentary than other Dwarf artillery, but nevertheless ruthlessly proficient at destroying their foes.	true
unit_description_short_texts_text_wh_main_unit_short_text_dwf_rune_smith	Forged Runes give the Runesmiths power to enhance allied weapons and armour, and nullify enemy magic to harmless lights.	true
unit_description_short_texts_text_wh_pro04_unit_short_text_chs_art_hellcannon_ror	Distorting the laws of nature, unnatural energies of Chaos imbue this Hellcannon with astonishingly quick firing rates and deadlier projectiles.	true
unit_description_short_texts_text_wh2_dlc11_unit_short_text_cst_mon_bloated_corpse	Swollen with volatile, noxious gases, their liquefying tissues strain dangerously under rotten and tattered skin.	true
unit_description_short_texts_text_wh_dlc05_unit_short_text_emp_grey_wizard	It is best not to speak ill of the Grey, for they are everywhere and nowhere all at once.	true
unit_description_short_texts_text_wh_dlc06_unit_short_text_dwf_belegar_ironhammer	A burning desire for vengeance and justice drives Belegar Ironhammer - he will reclaim his throne, no matter the cost.	true
unit_description_short_texts_text_wh2_dlc11_unit_short_text_cst_cav_knights_errant	Chastised in life due to their recklessness, these Knights exist past their deaths in an eternal state of ghostly damnation.	true
unit_description_short_texts_text_wh2_main_unit_short_text_lzd_cha_saurus_scar_veteran_2	Armed with spears and carrying bronze shields, these veteran warriors are the best warriors the Al Saurim have to offer.	true
unit_description_short_texts_text_wh2_main_unit_short_text_lzd_cha_saurus_scar_veteran_0	Armed with spears and carrying bronze shields, these veteran warriors are the best warriors the Al Saurim have to offer.	true
unit_description_short_texts_text_wh2_main_unit_short_text_lzd_cha_saurus_scar_veteran_1	Armed with spears and carrying bronze shields, these veteran warriors are the best warriors the Al Saurim have to offer.	true
unit_description_short_texts_text_wh2_dlc11_unit_short_text_cst_inf_deck_gunners_ror	Puppets of Vangheist’s cadaverous warship, driven by Dark Magic to inflict horror and damage in debilitating abundance.	true
unit_description_short_texts_text_wh_dlc08_unit_short_text_nor_marauder_hunters_1	The Hunter’s javelin takes down the largest of wild beasts, and the most gargantuan of foes.	true
unit_description_short_texts_text_wh_main_unit_short_text_vmp_vampires	In amongst the fighting, a Vampire is a danger to her enemies, a vicious warrior and uncompromisingly cruel.	true
unit_description_short_texts_text_wh_dlc07_unit_short_text_brt_prophetess_heavens	Trained by handmaidens of the Lady, these spellcasters bring nature's power to bear against the foes of Bretonnia.	true
unit_description_short_texts_text_wh2_main_unit_short_text_skv_cha_queek_headtaker	Queek is unscrupulous, vicious and without mercy. The Skaven, therefore, consider him most admirable.	true
unit_description_short_texts_text_wh_dlc08_unit_short_text_nor_skin_wolves_armoured	The half-feral, gore-obsessed Skin Wolves, armoured so their slaughter may continue unabated.	true
unit_description_short_texts_text_wh_dlc06_unit_short_text_dwf_warriors_of_dragonfire_pass	All are made or unmade in the crucible of Dragonfire Pass. So it is with these resolute, peerless Dwarf Warriors.	true
unit_description_short_texts_text_wh2_main_unit_short_text_def_mon_black_dragon	Poison, horns, claws and teeth; a myriad ways to destroy the foe.	true
unit_description_short_texts_text_wh_dlc04_unit_short_text_emp_arch_lector	His is the grim, unending task of uprooting and shattering evil in all its forms.	true
unit_description_short_texts_text_wh_main_unit_short_text_vmp_heinrich_kemmler	The dead answer my call. When you are dead, you will answer too!	true
unit_description_short_texts_text_wh2_main_unit_short_text_hef_inf_swordmasters_of_hoeth_0	Hoeth-forged steel cries out as its wielders lunge into battle, cutting down foe after foe with their greatswords.	true
unit_description_short_texts_text_wh2_dlc09_tmb_mon_necrosphinx_ror	The fury of the gods made stone, these chosen Sphinxes augment their brutal scythe-attack with magic and fire.	true
unit_description_short_texts_text_wh2_dlc09_tmb_inf_skeleton_spearmen_ror	Elite amongst their skeletal peers, these spear-armed warriors are as bloodthirsty as their infamous royal patron.	true
unit_description_short_texts_text_wh_dlc08_unit_short_text_nor_marauder_berserkers	Berserkers fight with the strength of madmen and an absolute disregard for their own lives. 	true
unit_description_short_texts_text_wh2_dlc10_unit_short_text_def_cav_raven_heralds_0	The Raven Heralds appear from nowhere, leaving piles of corpses in their wake.	true
unit_description_short_texts_text_wh_main_unit_short_text_vmp_banshees	Mighty in melee, Banshee also debilitate their enemies with fear-inducing screams and wails. Even the hardiest fall before this terror.	true
unit_description_short_texts_text_wh_main_unit_short_text_grn_doom_diver	Fired from a catapult with crude wings strapped to his arms, the cackling Goblin pilot guides himself to a messy, pointy-hatted impact.	true
unit_description_short_texts_text_wh2_dlc09_tmb_mon_sepulchral_stalkers_ror	Lying in wait, biding their time. The desert sees all. Nothing escapes.	true
unit_description_short_texts_text_wh_pro04_unit_short_text_nor_mon_skinwolves_ror	Armoured carapaces brindled with bloody gristle cover these truly voracious killers of frightening appearance.	true
unit_description_short_texts_text_wh_pro04_unit_short_text_nor_inf_marauder_berserkers_ror	Merciless and psychotic, these frenzied Berserkers kill with total devotion to the God of Warriors.	true
unit_description_short_texts_text_wh2_main_unit_short_text_skv_mon_hell_pit_abomination	The very image of madness and ruin; the ultimate rat-made menace unleashed.	true
unit_description_short_texts_text_wh_dlc06_unit_short_text_grn_moonhowlers	With a pining cry to the great, weird moon, Morrslieb, these wolves carry their Goblin riders to war.	true
unit_description_short_texts_text_wh_dlc04_unit_short_text_emp_knights_blazing_sun	Well-armoured and resplendent, the Knights deliver a fierce and destructive charge.	true
unit_description_short_texts_text_wh_dlc05_unit_short_text_wef_deepwood_scouts_0	Surprise is the greatest of weapons, enabling the stealthy to strike first and hardest, and tip the odds in their favour.	true
unit_description_short_texts_text_wh_dlc05_unit_short_text_wef_deepwood_scouts_1	Imagine the foe’s surprise when, in addition to the unexpected attack, their opponents loose two deadly, enchanted arrows at a time!	true
unit_description_short_texts_text_wh2_dlc10_unit_short_text_def_cha_sorceress_beasts	The control of beasts is usually the domain of Clar Karond, but there are Sorceresses who can wield the Wind of Ghur as well as any lash.	true
unit_description_short_texts_text_wh2_dlc09_tmb_cha_khalida	Khalida marches to war with all the poise she had in life, yet more brutal and merciless than ever.	true
unit_description_short_texts_text_wh2_main_unit_short_text_lzd_inf_temple_guards_blessed	Lethal Saurus marked for greatness by the Old Ones.	true
unit_description_short_texts_text_wh_dlc05_unit_short_text_wef_spellsinger	Whether casting supportive spells or waves of destruction, victory is carried by the song of spells.	true
unit_description_short_texts_text_wh_pro04_unit_short_text_wef_inf_waywatchers_ror	A shower of arrows let loose from behind a constricting wall of smoke awaits any trespassing enemies of the forest.	true
unit_description_short_texts_text_wh_dlc01_unit_short_text_chs_lord_change	A Lord of Change is imbued with the power of Tzeentch, able to sow madness and ruination amongst his foes.	true
unit_description_short_texts_text_wh_dlc06_unit_short_text_grn_deffcreepers	These arachnid aberrations make for powerful, terrifying mounts, bringing eight-legged death to their cowering foes.	true
unit_description_short_texts_text_wh_dlc01_unit_short_text_chs_sarthorael	Spoken of for many ages, this Lord of Change is favoured by Tzeentch himself, and fulfils his dark, malicious purpose.	true
unit_description_short_texts_text_wh_pro04_unit_short_text_wef_cav_wild_riders_ror	Otherworldly riders, swift and formidable, fighting viciously in the name of the Lord of all forests and beasts.	true
unit_description_short_texts_text_wh_dlc05_unit_short_text_wef_waywatchers	Those who enter Athel Loren without permission must answer for such a transgression.	true
unit_description_short_texts_text_wh_main_unit_short_text_chs_chaos_sorcerer_fire	This Chaos Sorcerer is a master of fire, summoning a great conflagration to consume all before him.	true
unit_description_short_texts_text_wh2_dlc12_unit_short_text_lzd_mon_ancient_stegadon_ror_0	Unfeasably large, even for an Ancient Stegadon, fear and dread accompanies this enormous specimen's ground-shaking stomp.	true
unit_description_short_texts_text_wh2_main_unit_short_text_skv_inf_poison_wind_globadiers	When a poisoned globe explodes, anyone caught in its radius is guaranteed to die a painful, pus-ridden death.	true
unit_description_short_texts_text_wh_main_unit_short_text_dwf_thorgrim	There will be no rest, no peace, until every page of the Dammaz Kron is accounted for!	true
unit_description_short_texts_text_wh2_dlc10_unt_short_text_hef_cha_hand_of_the_shadow_crown	The Shadow King’s right-hand Elf is as committed to the Druchii’s destruction as his murderous monarch.	true
unit_description_short_texts_text_wh2_dlc12_unit_short_text_lzd_cav_ripperdactyl_riders_0	Each rider fights with aggressive skill, but they pale in comparison to the viciousness of their mounts!	true
unit_description_short_texts_text_wh2_dlc09_tmb_inf_tomb_guard_great	Their great weapons are wielded as expertly as they did in life, slaying for Lord and glory!	true
unit_description_short_texts_text_wh_main_unit_short_text_vmp_black_coach	On the field of battle, Black Coaches channel magical energy, making them both stronger in defence and on the charge.	true
unit_description_short_texts_text_wh_dlc04_unit_short_text_vmp_feasters_in_the_dusk	These ghouls remember one thing - war - and they pursue that goal with single-minded savagery.	true
unit_description_short_texts_text_wh2_dlc10_unt_short_text_hef_cha_shadow_walker_0	The Shadow King’s right-hand Elf is just as committed to the Druchii’s destruction as his murderous monarch.	true
unit_description_short_texts_text_wh2_main_unit_short_text_skv_inf_clanrats_0_summoned	The cornerstone of the Skaven military, less numerous but better trained than the slave class.	true
unit_description_short_texts_text_wh_dlc07_unit_short_text_brt_peasant_bowmen_pox	Let poisoned arrows fly, and by blessed grace find their mark, though the bowmen may never know why.	true
unit_description_short_texts_text_wh_dlc05_unit_short_text_wef_hawk_riders	The bond between the Elves and the Hawks is unbreakable.	true
unit_description_short_texts_text_wh2_dlc09_tmb_inf_tomb_guard_ror	Like the flesh-eating, skull-faced beetle, whose name they bear, this dual-wielding, elite Tomb Guard bring a new level of terror to the battlefield.	true
unit_description_short_texts_text_wh2_main_unit_short_text_lzd_cav_cold_one_spearriders_blessed_0	Fierce beasts marked for greatness by the Old Ones.	true
unit_description_short_texts_text_wh2_dlc11_unit_short_text_cst_cha_noctilus	With power syphoned from the ocean’s Winds, the Dreadfleet commander seeks to drown the mortal world in a tide of death.	true
unit_description_short_texts_text_wh2_dlc11_unit_short_text_cst_sartosa_free_company	You'll never find a less trustworthy rabble, but for the right price they'll fight to the death... and beyond.	true
unit_description_short_texts_text_wh2_dlc11_unit_short_text_cst_mon_rotting_prometheans_gunnery_mob	A stampede of crab-like monsters is all the scarier when accompanied by the hisses and cracks of gunpowder weapons.	true
unit_description_short_texts_text_wh2_main_unit_short_text_skv_inf_death_globe_bombardiers	Developed by Clan Skryre, these poisoned-wind globes contain an even more virulent strain of deadly gas.	true
unit_description_short_texts_text_wh_pro04_unit_short_text_chs_mon_dragon_ogre_ror	Calling upon violent storms, these monsters manifest their anger in terrifying lightning displays that frequently end in mass death.	true
unit_description_short_texts_text_wh_dlc01_unit_short_text_chs_dragon_ogre	In battle is the only time a Dragon Ogre can die, so they fight with a powerful fury.	true
unit_description_short_texts_text_wh2_dlc09_tmb_mon_carrion	"The Carrion of the Desert, whose mighty outstretched wings darken the sun on the day of slaughter."	true
unit_description_short_texts_text_wh_pro04_unit_short_text_wef_inf_wardancers_ror	The most favoured Asrai of the Trickster God are dazzling, deceptive, and deadly in equal measure.	true
unit_description_short_texts_text_wh_dlc03_unit_short_text_boris_todbringer	Boris Todbringer is a man of singular action and determined purpose: to rid the forest of Khazrak's bestial scourge.	true
unit_description_short_texts_text_wh2_main_unit_short_text_hef_cha_noble_2	High Elf aristocrats are precise and calculating, and they bring this nature to the battlefield.	true
unit_description_short_texts_text_wh2_main_unit_short_text_hef_cha_noble_3	High Elf aristocrats are precise and calculating, and they bring this nature to the battlefield.	true
unit_description_short_texts_text_wh2_main_unit_short_text_hef_cha_noble_0	High Elf aristocrats are precise and calculating, and they bring this nature to the battlefield.	true
unit_description_short_texts_text_wh2_main_unit_short_text_hef_cha_noble_4	High Elf aristocrats are precise and calculating, and they bring this nature to the battlefield.	true
unit_description_short_texts_text_wh_dlc05_unit_short_text_emp_jade_wizard	Acolytes of the green Wind of Magic use the natural world and its seasons to heal and protect their companions.	true
unit_description_short_texts_text_wh_dlc04_unit_short_text_vmp_devils_swartzhafen	No longer Vampires, but fighting with the same insane savagery.	true
unit_description_short_texts_text_wh2_dlc11_unit_short_text_cst_cha_paladin	Even the very pinnacles of Bretonnian chivalry and brilliance are not immune to being conjured up as ethereal slaves.	true
unit_description_short_texts_text_wh2_dlc11_unit_short_text_vmp_lahmian_vampire_lord	Descended from Neferata, thought to be the very first Vampire, Lahmians are alluring, seductive, and deadly in equal measure.	true
unit_description_short_texts_text_wh_main_unit_short_text_chs_chaos_giant	A Giant is possessed of immense strength, and is devastatingly powerful when unleashed upon the opposition's battle line.	true
unit_description_short_texts_text_wh_dlc06_unit_short_text_grn_night_goblin_warboss	Although not as mighty as Orcs, Night Goblins nevertheless control their forces through fear and savage, macabre bloodlust.	true
unit_description_short_texts_text_wh_dlc03_unit_short_text_bst_ungor_herd	Though mocked by stronger beasts, Ungors nevertheless instil fear as they charge the foe down.	true
unit_description_short_texts_text_wh2_main_unit_short_text_skv_cha_plague_priest_2	The Harbinger of Disease guides their actions, blighting enemies with pus, pestilence, and scourge.	true
unit_description_short_texts_text_wh2_main_unit_short_text_skv_cha_plague_priest_0	The Harbinger of Disease guides their actions, blighting enemies with pus, pestilence, and scourge.	true
unit_description_short_texts_text_wh_main_unit_short_text_brt_spearmen_at_arms	Put a spear in a man's hand and tell him to brace and he will. He will also hope, and pray.	true
unit_description_short_texts_text_wh2_main_unit_short_text_hef_art_eagle_claw_bolt_thrower	The High Elves' chief artillery piece can mow down infantry and pierce Giants' hearts.	true
unit_description_short_texts_text_wh_dlc04_unit_short_text_emp_free_company_militia	These men did not ask for war, yet it has come all the same. With sword in hand, they fight because they must.	true
unit_description_short_texts_text_wh2_main_unit_short_text_lzd_cav_horned_ones_blessed_0	Savage horned beasts marked for greatness by the Old Ones. 	true
unit_description_short_texts_text_wh2_main_unit_short_text_skv_art_warp_lightning_cannon	This deadly weapon fires in the blink of an eye, leaving gaping holes and scorched earth in its wake.	true
unit_description_short_texts_text_wh_main_unit_short_text_vmp_varghulf	Amongst its enemies, a Varghulf is a savage whirl of limbs and claws, devastating in melee.	true
unit_description_short_texts_text_wh_dlc05_unit_short_text_wef_sisters_of_the_thorn	Ariel's handmaidens know only the defence of their Queen and the forest - an eternal duty, never forsworn.	true
unit_description_short_texts_text_wh_dlc07_unit_short_text_brt_peasant_bowmen_fire	The flame of the Lady goes with this arrow, and so too the low-born archer before long…	true
unit_description_short_texts_text_wh2_main_unit_short_text_hef_cav_dragon_princes	The weight of their ancestry is carried with them, skewering all-comers on their bloody lances.	true
unit_description_short_texts_text_wh_dlc06_unit_short_text_grn_teefrobbers	After riding their enemies down, what grim prize these Goblins claim is their own dark, devilish business.	true
unit_description_short_texts_text_wh2_main_unit_short_text_lzd_inf_temple_guards	The Lizardmen elite, charged to defend their sacred grounds, skewering interlopers at the end of their halberds.	true
unit_description_short_texts_text_wh_pro04_unit_short_text_brt_inf_foot_squires_ror	The Squires of the ‘Beastslayer’ Duke are amongst the hardiest of Bretonnian infantry, taking his epithet as their name for good reason.	true
unit_description_short_texts_text_wh2_dlc11_unit_short_text_cst_inf_zombie_gunnery_mob_handcannons	Where marksmanship might be lacking, a more powerful firearm will usually suffice.	true
unit_description_short_texts_text_wh_dlc08_unit_short_text_nor_norscan_ice_trolls	Mutations of the frozen north enable them to freeze their unfortunate victims with their foul, icy breath.	true
unit_description_short_texts_text_wh2_main_unit_short_text_def_cha_sorceress_fire	The hot, searing Red Wind blows down from the north to inflame passions and, if not used carefully, the spellcasters themselves.	true
unit_description_short_texts_text_wh2_main_unit_short_text_def_cha_sorceress_dark	The Dark Convent summon the Ruinous Powers to sow insanity amongst the foe.	true
unit_description_short_texts_text_wh_dlc06_unit_short_text_dwf_dragonback_slayers	These Slayers seek the ultimate blood sport, the greatest beasts, in their unending death-drive.	true
unit_description_short_texts_text_wh_dlc04_unit_short_text_vmp_konigstein_stalkers	Though most Undead are no more than stumbling thralls, these warriors have achieved renown due to their effectiveness in melee.	true
unit_description_short_texts_text_wh2_dlc11_unit_short_text_cst_inf_zombie_gunnery_mob_ror	The Pirate King’s personal band of zombie gunmen are a toxic mixture of black powder and noxious imbuements.	true
unit_description_short_texts_text_wh_dlc03_unit_short_text_bst_bray_shaman_shadows	Darkness marches before the Bray-Shaman, deceiving and destroying all in its path.	true
unit_description_short_texts_text_wh2_dlc11_unit_short_text_cst_cha_cylostra_direfin	The Siren of the Storm’s tortured soul vengefully roams the world’s seas, singing her paralysing songs of death.	true
unit_description_short_texts_text_wh2_dlc09_tmb_mon_ushabti	The physical embodiment of the everlasting gods; curse ye all men who look upon their divine forms!	true
unit_description_short_texts_text_wh_main_unit_short_text_chs_marauder_chieftain	Chieftains lead their Northmen marauders in Chaos' name, hurling themselves into the fray, where they remain until the very end.	true
unit_description_short_texts_text_wh_pro04_unit_short_text_bst_inf_centigors_ror	There are no Beastmen more loyal to the self-alleged father of all Centigors than these.	true
unit_description_short_texts_text_wh2_dlc12_unit_short_text_skv_inf_plague_monk_censer_bearer_ror_0	Good luck getting close enough to these foul, pestilential creatures to kill them without getting infected!	true
unit_description_short_texts_text_wh2_dlc10_unit_short_text_hef_inf_silverpelts_0	With hearts to match that of Charandis himself, the Puremane Company are fearless.	true
unit_description_short_texts_text_wh_dlc07_unit_short_text_brt_green_knight	The holder of secrets and keeper of the way, whose strength is the quester's ultimate test.	true
unit_description_short_texts_text_wh_main_unit_short_text_grn_orc_boar_big_uns	Bigger than normal Orcs, and stronger too, the Orc Boar Big 'Uns ride their beasts into enemy lines, devastating all who face them.	true
unit_description_short_texts_text_wh_main_unit_short_text_grn_orc_boar_chariot	When these Chariots ride to war, there is little that can stand in the way of their terrific charge.	true
unit_description_short_texts_text_wh_dlc05_unit_short_text_wef_waystalker	Never missing the mark, one alone is a deadly, formidable opponent.	true
